{
    "mapName": "Ponsa GP",
    "width": 200,
    "height": 112,
    "tileLayout": [
        "~~~~~~~~~~~~~~~~~~~~WWWWWWWWWWWWWWWWWWWWWWWWWWWWWWWWWWWWWWWWWWWWWWWWWWWWWWWWWWWWWWWWWWWWWWWWWWWWWWWWWWWWWWWWWWWWWWWWWWWWWWWWWWWWWWWWWWWWWWWWWWWWWWWWWWWWWWWWWWWW,WW,WWW,WW,WW,,,,,,,,,,,,,,,,,,,,,,,,,,,",
        "~~~~~~~~~~~~~~~~~~~~~WWWWWWWWWWWWWWWWWWWWWWWWWWWWWWWWWWWWWWWWWWWWWWWWWWWWWWWWWWWWWWWWWWWWWWWWWWWWWWWWWWWWWWWWWWWWWWWWWWWWWWWWWWWWWWWWWWWWWWWWWWWWWWWWWWWWWWWW,WWWWW,,W,,WW,,,,,,,,,,,,,,,,,,,,,,,,,,,,,,",
        "~~~~~~~~~~~~~~~~~~~~~WWWWWWWWWWWWWWWWWWWWWWWWWWWWWWWWW/-----------------------------------------------------------------#--------------------------------------WW,,,W,,W,,,,,,,,,,,,,,,,,,,,,,,,,,,,,,,,",
        "~~~~~~~~~~~~~~~~~~~~~~WWWWWWWWWWWWWWWWWWWWWWWWWWWWW/-/AAAAAAAAAAAAAAAAAAAAAAAAAAAAAAAAAAAAAAAAAAAAAAAAAAAAAAAAAAAAAAAAAA#AAAAAAAAAAAAAAAAAAAAAAAAAAAAAAAAAAAAAAAAAAAAA,,,,,W,,,,,,,,,,,,,,,,,,,,,,,,,,,,",
        "~~~~~~~~~~~~~~~~~~~~~~WWWWWWWWWWWWWWWWWWWWWWWW/---/AAAAAAAAAAAAAAAAAAAAAAAAAAAAAAAAAAAAAAAAAAAAAAAAAAAAAAAAAAAAAAAAAAAAA#AAAAAAAAAAAAAAAAAAAAAAAAAAAAAAAAAAAAAAAAAAAAAAAAAA,,,,,,,,,,,,,,,,,,,,,,,,,,,,,",
        "~~~~~~~~~~~~~~~~~~~~~~WWWWWWWWWWWWWWWWWWW/---/AAAAAAAAAAAAAAAAAAAAAAAAAAAAAAAAAAAAAAAAAAAAAAAAAAAAAAAAAAAAAAAAAAAAAAAAAA#AAAAAAAAAAAAAAAAAAAAAAAAAAAAAAAAAAAAAAAAAAAAAAAAAAAAA,,,,,,,,,,,,,,,,,,,,,,,,,,",
        "~~~~~~~~~~~~~~~~~~~~~~WWWWWWWWWWWWWWWWWW/AAAAAAAAAAAAAAAAAAAAAAAAAAAAAAAAAAAAAAAAAAAAAAAAAAAAAAAAAAAAAAAAAAAAAAAAAAAAAAA#AAAAAAAAAAAAAAAAAAAAAAAAAAAAAAAAAAAAAAAAAAAAAAAAAAAAAAA,,,,,,,,,,,,,,,,,,,,,,,,",
        "~~~~~~~~~~~~~~~~~~~~~~WWWWWWWWWWWWWWWWWW|AAAAAAAAAAAAAAAAAAAAAAAAAAAAAAAAAAAAAAAAAAAAAAAAAAAAAAAAAAAAAAAAAAAAAAAAAAAAAAA#AAAAAAAAAAAAAAAAAAAAAAAAAAAAAAAAAAAAAAAAAAAAAAAAAAAAAAAA,,,,,,,,,,,,,,,,,,,,,,,",
        "~~~~~~~~~~~~~~~~~~~~~~WWWWWWWWWWWWWWWWWW/AAAAAAAAAAAAAAAAAAAAAAAAAAAAAAAAAAAAAAAAAAAAAAAAAAAAAAAAAAAAAAAAAAAAAAAAAAAAAAA#AAAAAAAAAAAAAAAAAAAAAAAAAAAAAAAAAAAAAAAAAAAAAAAAAAAAAAAAAA,,,,,,,,,,,,,,,,,,,,,",
        "~~~~~~~~~~~~~~~~~~~~~~~WWWWWWWWWWWWWWWW/AAAAAAAAAAAAAAAAAAAAAAAAAAAAAAAAAAAAAAAAAAAAAAAAAAAAAAAAAAAAAAAAAAAAAAAAAAAAAAAA#AAAAAAAAAAAAAAAAAAAAAAAAAAAAAAAAAAAAAAAAAAAAAAAAAAAAAAAAAAAA,,,,,,,,,,,,,,,,,,,",
        "~~~~~~~~~~~~~~~~~~~~~~~WWWWWWWWWWWWWWW/AAAAAAAAAAAAAAAAAAAAAAAA/--------------------------------------------------------#------------------------------AAAAAAAAAAAAAAAAAAAAAAAAAAAAAAA,,,,,,,,,,,,,,,,,,",
        "~~~~~~~~~~~~~~~~~~~~~~~~~WWWWWWWWWWWWW|AAAAAAAAAAAAAAAAAAAAAAA/WWWWWWWWWWWWWWWWWWWWWWWWWWWWWWWWWWWWWWWWWWWWWWWWWWWWWWWWWWWWWWWWWWWWWWWWWWWWWWWWWWWWWWWWAAAAAAAAAAAAAAAAAAAAAAAAAAAAAAA,,,,,,,,,,,,,,,,,,",
        "~~~~~~~~~~~~~~~~~~~~~~~~~~WWWWWWWWWWWW|AAAAAAAAAAAAAAAAAAAA/-/WWWWWWWWWWWWWWWWWWWWWWWWWWWWWWWWWWWWWWWWWWWWWWWWWWWWWWWWWWWWWWWWWWWWWWWWWWWWWWWWWWWWWWWWWWWWWWWWWWAAAAAAAAAAAAAAAAAAAAAAA,,,,,,,,,,,,,,,,,",
        "~~~~~~~~~~~~~~~~~~~~~~~~~~~WWWWWWWWWWW|AAAAAAAAAAAAAAAAAAA/WWWWWWWWWWWWWWWWWWWWWWWWWWWWWWWWWWWWWWWWWWWWWWWWWWWWWWWWWWWWWWWWWWWWWWWWWWWWWWWWWWWWWWWWWWWWWWWWWWWWWWWWWWAAAAAAAAAAAAAAAAAA,,,,,,,,,,,,,,,,,",
        "~~~~~~~~~~~~~~~~~~~~~~~~~~~~WWWWWWWWWW|AAAAAAAAAAAAAAAAAAA|WWWWWWWWWWWWWWWWWWWWWWWWWWWWWWWWWWWWWWWWWWWWWWWWWWWWWWWWWWWWWWWWWWWWWWWWWWWWWWWWWWWWWWWWWWWWWWWWWWWWWWWWWWWWWAAAAAAAAAAAAAAA,,,,,,,,,,,,,,,,,",
        "~~~~~~~~~~~~~~~~~~~~~~~~~~~~WWWWWWWWWW|AAAAAAAAAAAAAAAAAAA|WWWWWWWWWWWWWWWWWWWWWWWWWWWWWWWWWWWWWWWWWWWWWWWWWWWWWWWWWWWWWWWWWWWWWWWWWWWWWWWWWWWWWWWWWWWWWWWWWWWWWWWWWWWWWWAAAAAAAAAAAAAAAA,,,,,,,,,,,,,,,",
        "~~~~~~~~~~~~~~~~~~~~~~~~~~~~~~WWWWWWWW|AAAAAAAAAAAAAAAAAAAAAWWWWWWWWWWWWWWWWWWWWWWWWWWWWWWWWWWWWWWWWWWWWWWWWWWWWWWWWWWWWWWWWWWWWWWWWWWWWWWWWWWWWWWWWWWWWWWWWWWWWWWWWWWWWWWWAAAAAAAAAAAAAA,,,,,,,,,,,,,,,",
        "~~~~~~~~~~~~~~~~~~~~~~~~~~~~~~WWWWWWWWAAAAAAAAAAAAAAAAAAAAAAAWWWWWWWWWWWWWWWWWWWWWWWWWWWWWWWWWWWWWWWWWWWWWWWWWWWWWWWWWWWWWWWWWWWWWWWWWWWWWWWWWWWWWWWWWWWWWWWWWWWWWWWWWWWWWWAAAAAAAAAAAAAA,,,,,,,,,,,,,,,",
        "~~~~~~~~~~~~~~~~~~~~~~~~~~~~~~~WWWWWWWAAAAAAAAAAAAAAAAAAAAAAAAAAWWWWWWWWWWWWWWWWWWWWAAAAAAAAAAAAAAAAAAAAAAAAAAAAAAAAAAAWWWWWWWWWWWWWWWWWWWWWWWWWWWWWWWWWWWWWWWWWWWWWWWWWWWWAAAAAAAAAAAAAA,,,,,,,,,,,,,,,",
        "~~~~~~~~~~~~~~~~~~~~~~~~~~~~~~~~WWWWWWWAAAAAAAAAAAAAAAAAAAAAAAAAAAAAAAAAAAAAAAAAAAAAAAAAAAAAAAAAAAAAAAAAAAAAAAAAAAAAAAAAAAAAWWWWWWWWWWWWWWWWWWWWWWWWWWWWWWWWWWWWWWWWWWWWWWWWAAAAAAAAAAAAAAA,,,,,,,,,,W,,",
        "~~~~~~~~~~~~~~~~~~~~~~~~~~~~~~~~WWWWWWWAAAAAAAAAAAAAAAAAAAAAAAAAAAAAAAAAAAAAAAAAAAAAAAAAAAAAAAAAAAAAAAAAAAAAAAAAAAAAAAAAAAAAAAAWWWWWWWWWWWWWWWWWWWWWWWWWWWWWWWWWWWWWWWWWWWWWAAAAAAAAAAAAAAA,,,,,,,,,WW,,",
        "~~~~~~~~~~~~~~~~~~~~~~~~~~~~~~~~~~~WWWWWAAAAAAAAAAAAAAAAAAAAAAAAAAAAAAAAAAAAAAAAAAAAAAAAAAAAAAAAAAAAAAAAAAAAAAAAAAAAAAAAAAAAAAAAAWWWWWWWWWWWWWWWWWWWWWWWWWWWWWWWWWWWWWWWWWWWAAAAAAAAAAAAAAA,,,,,,,W,,,W,",
        "~~~~~~~~~~~~~~~~~~~~~~~~~~~~~~~~~~~~WWWWAAAAAAAAAAAAAAAAAAAAAAAAAAAAAAAAAAAAAAAAAAAAAAAAAAAAAAAAAAAAAAAAAAAAAAAAAAAAAAAAAAAAAAAAAAWWWWWWWWWWWWWWWWWWWWWWWWWWWWWWWWWWWWWWWWWWAAAAAAAAAAAAAAA,,,W,,,,WW,WW",
        "~~~~~~~~~~~~~~~~~~~~~~~~~~~~~~~~~~~~~WWWWWAAAAAAAAAAAAAAAAAAAAAAAAAAAAAAAAAAAAAAAAAAAAAAAAAAAAAAAAAAAAAAAAAAAAAAAAAAAAAAAAAAAAAAAAAWWWWWWWWWWWWWWWWWWWWWWWWWWWWWWWWWWWWWWWWWAAAAAAAAAAAAAAA,,,W,,WWWWW,W",
        "~~~~~~~~~~~~~~~~~~~~~~~~~~~~~~~~~~~~~~WWWWWWWAAAAAAAAAAAAAAAAAAAAAAAAAAAAAAAAAAAAAAAAAAAAAAAAAAAAAAAAAAAAAAAAAAAAAAAAAAAAAAAAAAAAAAWWWWWWWWWWWWWWWWWWWWWWWWWWWWWWWWWWWWWWWWWAAAAAAAAAAAAAAA,,,,W,,WW,WWW",
        "~~~~~~~~~~~~~~~~~~~~~~~~~~~~~~~~~~~~~~~WWWWWWWWAAAAAAAAAAAAAAAAAAAAAAAAAAAAAAAAAAAAAAAAAAAAAAAAAAAAAAAAAAAAAAAAAAAAAAAAAAAAAAAAAAAAAWWWWWWWWWWWWWWWWWWWWWWWWWWWWWWWWWWWWWWWWAAAAAAAAAAAAAAAAW,WWWWWW,WWW",
        "~~~~~~~~~~~~~~~~~~~~~~~~~~~~~~~~~~~~~~~~WWWWWWWWWAAAAAAAAAAAAAAAAAAAAAAAAAAAAAAAAAAAAAAAAAAAAAAAAAAAAAAAAAAAAAAAAAAAAAAAAAAAAAAAAAAAAWWWWWWWWWWWWWWWWWWWWWWWWWWWWWWWWWWWWWWWWAAAAAAAAAAAAAAAWWW,WWWWWWWW",
        "~~~~~~~~~~~~~~~~~~~~~~~~~~~~~~~~~~~~~~~~WWWWWWWWWWWWAAAAAAAAAAAAAAAAAAAAAAAAAAAAWWWWWWWWWWWWWWWWWWWWWWWWW,,,,,,,,,AAAAAAAAAAAAAAAAAAAWWWWWWWWWWWWWWWWWWWWWWWWWWWWWWWWWWWWWWWWAAAAAAAAAAAAAAA,WWWWWWWWWWW",
        "~~~~~~~~~~~~~~~~~~~~~~~~~~~~~~~~~~~~~~~~~WWWWWWWWWWWWWWWWWWWWWWWWWWWWWWWWWWWWWWWWWWWWWWWWWWWWWWWWWWWWWWWWWWW,,,,,,,,,AAAAAAAAAAAAAAAAWWWWWWWWWWWWWWWWWWWWWWWWWWWWWWWWWWWWWWWWAAAAAAAAAAAAAAAWWWWWWWWWWWW",
        "~~~~~~~~~~~~~~~~~~~~~~~~~~~~~~~~~~~~~~~~~WWWWWWWWWWWWWWWWWWWWWWWWWWWWWWWWWWWWWWWWWWWWWWWWWWWWWWWWWWWWWWWWWWWWWW,,,,,,,AAAAAAAAAAAAAAAAWWWWWWWWWWWWWWWWWWWWWWWWWWWWWWWWWWWWWWWAAAAAAAAAAAAAAAWWWWWWWWWWWW",
        "~~~~~~~~~~~~~~~~~~~~~~~~~~~~~~~~~~~~~~~~~~WWWWWWWWWWWWWWWWWWWWWWWWWWWWWWWWWWWWWWWWWWWWWWWWWWWWWWWWWWWWWWWWWWWWWW,,,,,,AAAAAAAAAAAAAAAAWWWWWWWWWWWWWWWWWWWWWWWWWWWWWWWWWWWWWWWAAAAAAAAAAAAAAAWWWWWWWWWWWW",
        "~~~~~~~~~~~~~~~~~~~~~~~~~~~~~~~~~~~~~~~~~~~~WWWWWWWWWWWWWWWWWWWWWWWWWWWWWWWWWWWWWWWWWWWWWWWWWWWWWWWWWWWWWWWWWWWWW,,,,,,AAAAAAAAAAAAAAAWWWWWWWWWWWWWWWWWWWWWWWWWWWWWWWWWWWWWWWWAAAAAAAAAAAAAAWWWWWWWWWWWW",
        "~~~~~~~~~~~~~~~~~~~~~~~~~~~~~~~~~~~~~~~~~~~~WWWWWWWWWWWWWWWWWWWWWWWWWWWWWWWWWWWWWWWWWWWWWWWWWWWWWWWWWWWWWWWWWWWWW,,,,,,AAAAAAAAAAAAAAAWWWWWWWWWWWWWWWWWWWWWWWWWWWWWWWWWWWWWWWWAAAAAAAAAAAAAAWWWWWWWWWWWW",
        "~~~~~~~~~~~~~~~~~~~~~~~~~~~~~~~~~~~~~~~~~~~~~WWWWWWWWWWWWWWWWWWWWWWWWWWWWWWWW,,,,,,,,,,,,,,WWWWWWWWWWWWWWWWWWWWWW,,,,,,AAAAAAAAAAAAAAAWWWWWWWWWWWWWWWWWWWWWWWWWWWWWWWWWWWWWWWWAAAAAAAAAAAAAAWWWWWWWWWWWW",
        "~~~~~~~~~~~~~~~~~~~~~~~~~~~~~~~~~~~~~~~~~~~~~~WWWWWWWWWWWWWWWWWWWWWWWW,,,,,,,,,,,,,,,,,,,,,,,,,,WWWWWWWWWWWWWWWWW,,,,,,AAAAAAAAAAAAAAAWWWWWWWWWWWWWWWWWWWWWWWWWWWWWWWWWWWWWWWWAAAAAAAAAAAAAAWWWWWWWWWWWW",
        "~~~~~~~~~~~~~~~~~~~~~~~~~~~~~~~~~~~~~~~~~~~~~~WWWWWWWWWWWWWWWWWWWW,,,,,,,,,,,,,,,,,,,,,,,,,,,,,,,,,,,,WWWWWWWWWW,,,,,,,AAAAAAAAAAAAAAWWWWWWWWWWWWWWWWWWWWWWWWWWWWWWWWWWWWWWWWWWAAAAAAAAAAAAAWWWWWWWWWWWW",
        "~~~~~~~~~~~~~~~~~~~~~~~~~~~~~~~~~~~~~~~~~~~~~~WWWWWWWWWWWWWWW,,,,,,,,,,,,,,,,,,,,,,,,,,,,,,,,,,,,,WWWWWWWWWWWWWW,,,,,,AAAAAAAAAAAAAAAWWWWWWWWWWWWWWWWWWWWWWWWWWWWWWWWWWWWWWWWWWAAAAAAAAAAAAAWWWWWWWWWWWW",
        "~~~~~~~~~~~~~~~~~~~~~~~~~~~~~~~~~~~~~~~~~~~~~~~~WWWWWWWWW,,,,,,,,,,,,,,,,,,,,,,,,,,,,,,,,,,WWWWWWWWWWWWWWWWWWWW,,,,,,AAAAAAAAAAAAAAAAWWWWWWWWWWWWWWWWWWWWWWWWWWWWWWWWWWWWWWWWWWAAAAAAAAAAAAAWWWWWWWWWWWW",
        "~~~~~~~~~~~~~~~~~~~~~~~~~~~~~~~~~~~~~~~~~~~~~~~~WWWWWWWWWW,,,,,,,,,,,,,,,,,,,,,,,,,,,,,,,WWWWWWWWWWWWWWWWWWWWWW,,,,,AAAAAAAAAAAAAAAAAWWWWWWWWWWWWWWWWWWWWWWWWWWWWWWWWWWWWWWWWWWAAAAAAAAAAAAAWWWWWWWWWWWW",
        "~~~~~~~~~~~~~~~~~~~~~~~~~~~~~~~~~~~~~~~~~~~~~~~~WWWWWWWWWWWWW,,,,,,,,,,,,,,,,,,WWWWWWWWWWWWWWWWWWWWWWWWWWWWWWW,,,,,AAAAAAAAAAAAAAAAAWWWWWWWWWWWWWWWWWWWWWWWWWWWWWWWWWWWWWWWWWWWAAAAAAAAAAAAAWWWWWWWWWWWW",
        "~~~~~~~~~~~~~~~~~~~~~~~~~~~~~~~~~~~~~~~~~~~~~~~~WWWWWWWWWWWWWWWWWWWWWW,,,,WWWWWWWWWWWWWWWWWWWWWWWWWWWWWWWWWWW,,,,,AAAAAAAAAAAAAAAAAAWWWWWWWWWWWWWWWWWWWWWWWWWWWWWWWWWWWWWWWWWWWAAAAAAAAAAAAAWWWWWWWWWWWW",
        "~~~~~~~~~~~~~~~~~~~~~~~~~~~~~~~~~~~~~~~~~~~~~~~~WWWWWWWWWWWWWWWWWWWWWWWWWWWWWWWWWWWWWWWWWWWWWWWWWWWWWWWWWWWW,,,,AAAAAAAAAAAAAAAAAAAAWWWWWWWWWWWWWWWWWWWWWWWWWWWWWWWWWWWWWWWWWWWAAAAAAAAAAAAWWWWWWWWWWWWW",
        "~~~~~~~~~~~~~~~~~~~~~~~~~~~~~~~~~~~~~~~~~~~~~~~WWWWWWWWWWWWWWWWWWWWWWWWWWWWWWWWWWWWWWWWWWWWWWWWWWWWWWWWWWWW,,,AAAAAAAAAAAAAAAAAAAAAWWWWWWWWWWWWWWWWWWWWWWWWWWWWWWWWWWWWWWWWWWWWAAAAAAAAAAAAWWWWWWWWWWWWW",
        "~~~~~~~~~~~~~~~~~~~~~~~~~~~~~~~~~~~~~~~~~~~~~~~WWWWWWWWWWWWWWWWWWWWWWWWWWWWWWWWWWWWWWWWWWWWWWWWWWWWWWWWWW,,,,AAAAAAAAAAAAAAAAAAAAAWWWWWWWWWWWWWWWWWWWWWWWWWWWWWWWWWWWWWWWWWWWWAAAAAAAAAAAAAWWWWWWWWWWWWW",
        "~~~~~~~~~~~~~~~~~~~~~~~~~~~~~~~~~~~~~~~~~~~~~~~WWWWWWWWWWWWWWWWWWWWWWWWWWWWWWWWWWWWWWWWWWWWWWWWWWWWWWWWAAAAAAAAAAAAAAAAAAAAAAAAAAAWWWWWWWWWWWWWWWWWWWWWWWWWWWWWWWWWWWWWWWWWWWWAAAAAAAAAAAAAWWWWWWWWWWWWW",
        "~~~~~~~~~~~~~~~~~~~~~~~~~~~~~~~~~~~~~~~~~~~~~~~WWWWWWWWWWWWWWWWWWWWWWWWWWWWWWWWWWWWWWWWWWWWWWWWWWWWAAAAAAAAAAAAAAAAAAAAAAAAAAAAAAWWWWWWWWWWWWWWWWWWWWWWWWWWWWWWWWWWWWWWWWWWWWWAAAAAAAAAAAAAWWWWWWWWWWWWW",
        "~~~~~~~~~~~~~~~~~~~~~~~~~~~~~~~~~~~~~~~~~~~~~~~WWWWWWWWWWWWWWWWWWWWWWWWWWWWWWWWWWWWWWWWWWWWWWAAAAAAAAAAAAAAAAAAAAAAAAAAAAAAAAAAAWWWWWWWWWWWWWWWWWWWWWWWWWWWWWWWWWWWWWWWWWWWWWWAAAAAAAAAAAAAWWWWWWWWWWWWW",
        "~~~~~~~~~~~~~~~~~~~~~~~~~~~~~~~~~~~~~~~~~~~~~~~WWWWWWWWWWWWWWWWWWWWWWWWWWWWWWWWWWWWWWWWWAAAAAAAAAAAAAAAAAAAAAAAAAAAAAAAAAAAAAAWWWWWWWWWWWWWWWWWWWWWWWWWWWWWWWWWWWWWWWWWWWWWWWWAAAAAAAAAAAAAWWWWWWWWWWWWW",
        "~~~~~~~~~~~~~~~~~~~~~~~~~~~~~~~~~~~~~~~~~~~~~~~WWWWWWWWWWWWWWWWWWWWWWWWWWWWWWWWWWWWAAAAAAAAAAAAAAAAAAAAAAAAAAAAAAAAAAAAAAAAAAWWWWWWWWWWWWWWWWWWWWWWWWWWWWWWWWWWWWWWWWWWWWWWWWAAAAAAAAAAAAAAWWWWWWWWWWWWW",
        "~~~~~~~~~~~~~~~~~~~~~~~~~~~~~~~~~~~~~~~~~~~~~~~WWWWWWWWWWWWWWWWWWWWWWWWWWWWWWWWAAAAAAAAAAAAAAAAAAAAAAAAAAAAAAAAAAAAAAAAAAAAAWWWWWWWWWWWWWWWWWWWWWWWWWWWWWWWWWWWWWWWWWWWWWWWWWAAAAAAAAAAAAAWWWWWWWWWWWWWW",
        "~~~~~~~~~~~~~~~~~~~~~~~~~~~~~~~~~~~~~~~~~~~~~~~~WWWWWWWWWWWWWWWWWWWWWWWWWWWWWAAAAAAAAAAAAAAAAAAAAAAAAAAAAAAAAAAAAAAAAAAAAAWWWWWWWWWWWWWWWWWWWWWWWWWWWWWWWWWWWWWWWWWWWWWWWWWWWAAAAAAAAAAAAAWWWWWWWWWWWWWW",
        "~~~~~~~~~~~~~~~~~~~~~~~~~~~~~~~~~~~~~~~~~~~~~~~~WWWWWWWWWWWWWWWWWWWWWWWWWWWAAAAAAAAAAAAAAAAAAAAAAAAAAAAAAAAAAAAAAAAAWWWWWWWWWWWWWWWWWWWWWWWWWWWWWWWWWWWWWWWWWWWWWWWWWWWWWWWWWAAAAAAAAAAAAAWWWWWWWWWWWWWW",
        "~~~~~~~~~~~~~~~~~~~~~~~~~~~~~~~~~~~~~~~~~~~~~~~~WWWWWWWWWWWWWWWWWWWWWWWWWWAAAAAAAAAAAAAAAAAAAAAAAAAAAAAAAAAAAAAAAWWWWWWWWWWWWWWWWWWWWWWWWWWWWWWWWWWWWWWWWWWWWWWWWWWWWWWWWWWWAAAAAAAAAAAAAAWWWWWWWWWWWWWW",
        "~~~~~~~~~~~~~~~~~~~~~~~~~~~~~~~~~~~~~~~~~~~~~~~~WWWWWWWWWWWWWWWWWWWWWWWWWAAAAAAAAAAAAAAAAAAAAAAAAAAAAAAAAAAAAAAWWWWWWWWWWWWWWWWWWWWWWWWWWWWWWWWWWWWWWWWWWWWWWWWWWWWWWWWWWWWWAAAAAAAAAAAAAAWWWWWWWWWWWWWW",
        "~~~~~~~~~~~~~~~~~~~~~~~~~~~~~~~~~~~~~~~~~~~~~~~~WWWWWWWWWWWWWWWWWWWWWWWWWAAAAAAAAAAAAAAAAAAAAAAAAAAAAAAWWWWWWWWWWWWWWWWWWWWWWWWWWWWWWWWWWWWWWWWWWWWWWWWWWWWWWWWWWWWWWWWWWWWWAAAAAAAAAAAAAWWWWWWWWWWWWWWW",
        "~~~~~~~~~~~~~~~~~~~~~~~~~~~~~~~~~~~~~~~~~~~~~~~~WWWWWWWWWWWWWWWWWWWWWWWWWAAAAAAAAAAAAAAAAAAAAAAAAAAWWWWWWWWWWWWWWWWWWWWWWWWWWWWWWWWWWWWWWWWWWWWWWWWWWWWWWWWWWWWWWWWWWWWWWWWAAAAAAAAAAAAAAWWWWWWWWWWWWWWW",
        "~~~~~~~~~~~~~~~~~~~~~~~~~~~~~~~~~~~~~~~~~~~~~~~~WWWWWWWWWWWWWWWWWWWWWWWWWAAAAAAAAAAAAAAAAAAAAAAAWWWWWWWWWWWWWWWWWWWWWWWWWWWWWWWWWWWWWWWWWWWWWWWWWWWWWWWWWWWWWWWWWWWWWWWWWWWAAAAAAAAAAAAAAWWWWWWWWWWWWWWW",
        "~~~~~~~~~~~~~~~~~~~~~~~~~~~~~~~~~~~~~~~~~~~~~~~~WWWWWWWWWWWWWWWWWWWWWWWWWAAAAAAAAAAAAAAAAAAWWWWWWWWWWWWWWWWWWWWWWWWWWWWWWWWWWWWWWWWWWWWWWWWWWWWWWWWWWWWWWWWWWWWWWWWWWWWWWWWAAAAAAAAAAAAAAWWWWWWWWWWWWWWW",
        "~~~~~~~~~~~~~~~~~~~~~~~~~~~~~~~~~~~~~~~~~~~~~~~~WWWWWWWWWWWWWWWWWWWWWWWWWAAAAAAAAAAAAAAWWWWWWWWWWWWWWWWWWWWWWWWWWWWWWWWWWWWWWWWWWWWWWWWWWWWWWWWWWWWWWWWWWWWWWWWWWWWWWWWWWWAAAAAAAAAAAAAAAWWWWWWWWWWWWWWW",
        "~~~~~~~~~~~~~~~~~~~~~~~~~~~~~~~~~~~~~~~~~~~~~~~~WWWWWWWWWWWWWWWWWWWWWWWWAAAAAAAAAAAAAAWWWWWWWWWWWWWWWWWWWWWWWWWWWWWWWWWWWWWWWWWWWWWWWWWWWWWWWWWWWWWWWWWWWWWWWWWWWWWWWWWWWWAAAAAAAAAAAAAAWWWWWWWWWWWWWWWW",
        "~~~~~~~~~~~~~~~~~~~~~~~~~~~~~~~~~~~~~~~~~~~~~~~~WWWWWWWWWWWWWWWWWWWWWWWWAAAAAAAAAAAAAAWWWWWWWWWWWWWWWWWWWWWWWWWWWWWWWWWWWWWWWWWWWWWWWWWWWWWWWWWWWWWWWWWWWWWWWWWWWWWWWWWWWAAAAAAAAAAAAAAAWWWWWWWWWWWWWWWW",
        "~~~~~~~~~~~~~~~~~~~~~~~~~~~~~~~~~~~~~~~~~~~~~~~WWWWWWWWWWWWWWWWWWWWWWWWWAAAAAAAAAAAAAAWWWWWWWWWWWWWWWWWWWWWWWWWWWWWWWWWWWWWWWWWWWWWWWWWWWWWWWWWWWWWWWWWWWWWWWWWWWWWWWWWWWAAAAAAAAAAAAAAAWWWWWWWWWWWWWWWW",
        "~~~~~~~~~~~~~~~~~~~~~~~~~~~~~~~~~~~~~~~~~~~~~~~WWWWWWWWWWWWWWWWWWWWWWWWWAAAAAAAAAAAAAWWWWWWWWWWWWWWWWWWWWWWWWWWWWWWWWWWWWWWWWWWWWWWWWWWWWWWWWWWWWWWWWWWWWWWWWWWWWWWWWWWWWAAAAAAAAAAAAAAAWWWWWWWWWWWWWWWW",
        "~~~~~~~~~~~~~~~~~~~~~~~~~~~~~~~~~~~~~~~~~~~~~~WWWWWWWWWWWWWWWWWWWWWWWWWWAAAAAAAAAAAAAWWWWWWWWWWWWWWWWWWWWWWWWWWWWWWWWWWWWWWWWWWWWWWWWWWWWWWWWWWWWWWWWWWWWWWWWWWWWWWWWWWWAAAAAAAAAAAAAAAWWWWWWWWWWWWWWWWW",
        "~~~~~~~~~~~~~~~~~~~~~~~~~~~~~~~~~~~~~~~~~~~~~~WWWWWWWWWWWWWWWWWWWWWWWWWWAAAAAAAAAAAAAWWWWWWWWWWWWWWWWWWWWWWWWWWWWWWWWWWWWWWWWWWWWWWWWWWWWWWWWWWWWWWWWWWWWWWWWWWWWWWWWWWAAAAAAAAAAAAAAAAWWWWWWWWWWWWWWWWW",
        "~~~~~~~~~~~~~~~~~~~~~~~~~~~~~~~~~~~~~~~~~~~~~~WWWWWWWWWWWWWWWWWWWWWWWWWWAAAAAAAAAAAAAWWWWWWWWWWWWWWWWWWWWWWWWWWWWWWWWWWWWWWWWWWWWWWWWWWWWWWWWWWWWWWWWWWWWWWWWWWWWWWWWWWAAAAAAAAAAAAAAAAW,WWWWWWWWWWWWWWW",
        "~~~~~~~~~~~~~~~~~~~~~~~~~~~~~~~~~~~~~~~~~~~~.WWWWWWWWWWWWWWWWWWWWWWWWWWWAAAAAAAAAAAAAWWWWWWWWWWWWWWWWWWWWWWWWWWWWWWWWWWWWWWWWWWWWWWWWWWWWWWWWWWWWWWWWWWWWWWWWWWWWWWWWWAAAAAAAAAAAAAAAAWW,,W,WWWWWWWWWWWW",
        "~~~~~~~~~~~~~~~~~~~~~~~~~~~~~~~~~~~~~~~~~~~~.WWWWWWWWWWWWWWWWWWWWWWWWWWWAAAAAAAAAAAAAWWWWWWWWWWWWWWWWWWWWWWWWWWWWWWWWWWWWWWWWWWWWWWWWWWWWWWWWWWWWWWWWWWWWWWWWWWWWWWWWAAAAAAAAAAAAAAAAA,WWW,WWWWWWWWWWWWW",
        "~~~~~~~~~~~~~~~~~~~~~~~~~~~~~~~~~~~~~~~~~~~...WWWWWWWWWWWWWWWWWWWWWWWWWWAAAAAAAAAAAAAWWWWWWWWWWWWWWWWWWWWWWWWWWWWWWWWWWWWWWWWWWWWWWWWWWWWWWWWWWWWWWWWWWWWWWWWWWWWWWWAAAAAAAAAAAAAA,AA,,,,W,W,WWWWWWWWWWW",
        "~~~~~~~~~~~~~~~~~~~~~~~~~~~~~~~~~~~~~~~~~~~...WWWWWWWWWWWWWWWWWWWWWWWWWWAAAAAAAAAAAAAWWWWWWWWWWWWWWWWWWWWWWWWWWWWWWWWWWWWWWWWWWWWWWWWWWWWWWWWWWWWWWWWWWWWWWWWWWWWWAAAAAAAAAAAAAAAAAAA,,,,,,W,WWWWWWWWWWW",
        "~~~~~~~~~~~~~~~~~~~~~~~~~~~~~~~~~~~~~~~~~~....WWWWWWWWWWWWWWWWWWWWWWWWWWAAAAAAAAAAAAAWWWWWWWWWWWWWWWWWWWWWWWWWWWWWWWWWWWWWWWWWWWWWWWWWWWWWWWWWWWWWWWWWWWWWWWWWWWAAAAAAAAAAAAAAAAAAAA,,,,,,,W,W,WWWWWWWWW",
        "~~~~~~~~~~~~~~~~~~~~~~~~~~~~~~~~~~~~~~~~~~....WWWWWWWWWWWWWWWWWWWWWWWWWWAAAAAAAAAAAAAWWWWWWWWWWWWWWWWWWWWWWWWWWWWWWWWWWWWWWWWWWWWWWWWWWWWWWWWWWWWWWWWWWWWWWWWWAAAAAAAAAAAAAAAAAAA,A,,,,,,,,WW,WWWWWWWWWW",
        "~~~~~~~~~~~~~~~~~~~~~~~~~~~~~~~~~~~~~~~~~....WWWWWWWWWWWWWWWWWWWWWWWWWWWAAAAAAAAAAAAAWWWWWWWWWWWWWWWWWWWWWWWWWWWWWWWWWWWWWWWWWWWWWWWWWWWWWWWWWWWWWWWWWWWWWWWAAAAAAAAAAAAAAAAAAAAAA,,,,,,,,,,WWWWWWWWWWWW",
        "~~~~~~~~~~~~~~~~~~~~~~~~~~~~~~~~~~~~~~~~~....WWWWWWWWWWWWWWWWWWWWWWWWWWWAAAAAAAAAAAAAWWWWWWWWWWWWWWWWWWWWWWWWWWWWWWWWWWWWWWWWWWWWWWWWWWWWWWWWWWWWWWWWWWWWWAAAAAAAAAAAAAAAAAAAA,AAA,,,,,,,,,WW,WWWWWWWWWW",
        "~~~~~~~~~~~~~~~~~~~~~~~~~~~~~~~~~~~~~~~~~....WWWWWWWWWWWWWWWWWWWWWWWWWWWAAAAAAAAAAAAAWWWWWWWWWWWWWWWWWWWWWWWWWWWWWWWWWWWWWWWWWWWWWWWWWWWWWWWWWWWWWWWWWWWAAAAAAAAAAAAAAAAAAAAAAAAA,,,,,,,,,,W,WWWWWWWWWWW",
        "~~~~~~~~~~~~~~~~~~~~~~~~~~~~~~~~~~~~~~~~....WWWWWWWWWWWWWWWWWWWWWWWWWWWWAAAAAAAAAAAAAWWWWWWWWWWWWWWWWWWWWWWWWWWWWWWWWWWWWWWWWWWWWWWWWWWWWWWWWWWWWWWWWWAAAAAAAAAAAAAAAAAAAAAA,AAAA,,,,,,,,,,,W,W,WWWWWWWW",
        "~~~~~~~~~~~~~~~~~~~~~~~~~~~~~~~~~~~~~~~.....WWWWWWWWWWWWWWWWWWWWWWWWWWWWAAAAAAAAAAAAAWWWWWWWWWWWWWWWWWWWWWWWWWWWWWWWWWWWWWWWWWWWWWWWWWWWWWWWWWWWWWWWAAAAAAAAAAAAAAAAAAAAAAAAAAAA,,,,,,,,,,,WW,WWWWWWWWWW",
        "~~~~~~~~~~~~~~~~~~~~~~~~~~~~~~~~~~~~~~.....WWWWWWWWWWWWWWWWWWWWWWWWWWWWWAAAAAAAAAAAAAWWWWWWWWWWWWWWWWWWWWWWWWWWWWWWWWWWWWWWWWWWWWWWWWWWWWWWWWWWWWWAAAAAAAAAAAAAAAAAAAAAAAAAAAAA,,,,,,,,,,,,WW,WWWWWWWWWW",
        "~~~~~~~~~~~~~~~~~~~~~~~~~~~~~~~~~~~~~......WWWWWWWWWWWWWWWWWWWWWWWWWWWWWAAAAAAAAAAAAAWWWWWWWWWWWWWWWWWWWWWWWWWWWWWWWWWWWWWWWWWWWWWWWWWWWWWWWWWWWAAAAAAAAAAAAAAAAAAAAAAAAAAAAAA,,,,,,,,,,,,,,WWWWWWWWWWWW",
        "~~~~~~~~~~~~~~~~~~~~~~~~~~~~~~~~~~~~~......WWWWWWWWWWWWWWWWWWWWWWWWWWWWWAAAAAAAAAAAAAWWWWWWWWWWWWWWWWWWWWWWWWWWWWWWWWWWWWWWWWWWWWWWWWWWWWWWWWWAAAAAAAAAAAAAAAAAAAAAAAAAAA,AAA,,,,,,,,,,,,,WWWWWWWWWWWWWW",
        "~~~~~~~~~~~~~~~~~~~~~~~~~~~~~~~~~~~~......WWWWWWWWWWWWWWWWWWWWWWWWWWWWWWAAAAAAAAAAAAAWWWWWWWWWWWWWWWWWWWWWWWWWWWWWWWWWWWWWWWWWWWWWWWWWWWWWWWAAAAAAAAAAAAAAAAAAAAAAAAAAAAA,AA,,,,,,,,,,,,,WW,W,WWWWWWWWWW",
        "~~~~~~~~~~~~~~~~~~~~~~~~~~~~~~~~~~........WWWWWWWWWWWWWWWWWWWWWWWWWWWWWWAAAAAAAAAAAAAWWWWWWWWWWWWWWWWWWWWWWWWWWWWWWWWWWWWWWWWWWWWWWWWWWWWWAAAAAAAAAAAAAAAAAAAAAAAAAAAAAAAAA,,,,,,,,,,,,,,WW,WWWWWWWWWWWW",
        "~~~~~~~~~~~~~~~~~~~~~~~~~~~~~~~~..........WWWWWWWWWWWWWWWWWWWWWWWWWWWWWWAAAAAAAAAAAAAWWWWWWWWWWWWWWWWWWWWWWWWWWWWWWWWWWWWWWWWWWWWWWWWWWWAAAAAAAAAAAAAAAAAAAAAAAAAAAAAAAAA,,,,,,,,,,,,,,,,W,WWWWWWWWWWWWW",
        "~~~~~~~~~~~~~~~~~~~~~~~~~~~~~~~...........WWWWWWWWWWWWWWWWWWWWWWWWWWWWWWAAAAAAAAAAAAAWWWWWWWWWWWWWWWWWWWWWWWWWWWWWWWWWWWWWWWWWWWWWWWWWAAAAAAAAAAAAAAAAAAAAAAAAAAAAAAAAAWW,W,,,,,,,,,,,,,WWWWWWWWWWWWWWWW",
        "~~~~~~~~~~~~~~~~~~~~~~~~~~~~~............WWWWWWWWWWWWWWWWWWWWWWWWWWWWWWWAAAAAAAAAAAAA,WWWWWWWWWWWWWWWWWWWWWWWWWWWWWWWWWWWWWWWWWWWWWWAAAAAAAAAAAAAAAAAAAAAAAAAAAAAAAAAWW,WWW,,,,,,,,,,,,,,WWWWWWWWWWWWWWW",
        "~~~~~~~~~~~~~~~~~~~~~~~~~~~~.............WWWWWWWWWWWWWWWWWWWWWWWWWWWWWWWAAAAAAAAAAAAA,WWWWWWWWWWWWWWWWWWWWWWWWWWWWWWWWWWWWWWWWWWWWAAAAAAAAAAAAAAAAAAAAAAAAAAAAAAAAAWWWWWWW,,,,,,,,,,,,,,W,WWWWWWWWWWWWWW",
        "~~~~~~~~~~~~~~~~~~~~~~~~~~~..............WWWWWWWWWWWWWWWWWWWWWWWWWWWWWWWAAAAAAAAAAAAA,,WWWWWWWWWWWWWWWWWWWWWWWWWWWWWWWWWWWWWWWWWAAAAAAAAAAAAAAAAAAAAAAAAAAAAAAAAAWWWWWWW,WW,,,,,,,,,,,,,,WW,,WWWWWWWWWWW",
        "~~~~~~~~~~~~~~~~~~~~~~~~~~...............WWWWWWWWWWWWWWWWWWWWWWWWWWWWWWWAAAAAAAAAAAAA,,WWWWWWWWWWWWWWWWWWWWWWWWWWWWWWWWWWW,,,,AAAAAAAAAAAAAAAAAAAAAAAAAAAAAAAAAWWWWWWWW,W,,,,,,,,,,,,,WW,WWWWWWWWWWWWWWW",
        "~~~~~~~~~~~~~~~~~~~~~~~~~~...............WWWWWWWWWWWWWWWWWWWWWWWWWWWWWWWAAAAAAAAAAAAA,,WWWWWWWWWWWWWWWWWWWWWWWWWWWWWWWW,,,,,AAAAAAAAAAAAAAAAAAAAAAAAAAAAAAAAAWWWWWWWWWWW,W,,,,,,,,,,,,WWWWWWWWWWWWWWWWWW",
        "~~~~~~~~~~~~~~~~~~~~~~~~~................WWWWWWWWWWWWWWWWWWWWWWWWWWWWWWWAAAAAAAAAAAAA,,,,WWWWWWWWWWWWWWWWWWWWWWWWW,,,,,,,,AAAAAAAAAAAAAAAAAAAAAAAAAAAAAAAAAWWWWWWWWWWW,WWW,,,,,,,,,,,,,W,WWWWWWWWWWWWWWW",
        "~~~~~~~~~~~~~~~~~~~~~~~~~................WWWWWWWWWWWWWWWWWWWWWWWWWWWWWWWAAAAAAAAAAAAA,,,,,,,WWWWWWWWWWWWWWWW,,,,,,,,,,,,AAAAAAAAAAAAAAAAAAAAAAAAAAAAAAAAAWWWWWWWWWWWWWW,W,,,,,,,,,,,,,,,WWWWWWWWWWWWWWWW",
        "~~~~~~~~~~~~~~~~~~~~~~~~~...............WWWWWWWWWWWWWWWWWWWWWWWWWWWWWWWWAAAAAAAAAAAAA,,,,,,,,,,,,,,,,,,,,,,,,,,,,,,,,,AAAAAAAAAAAAAAAAAAAAAAAAAAAAAAAAAWWWWWWWWWWWWW,WW,W,,,,,,,,,,,,,,,,WWW,WWWWWWWWWWW",
        "~~~~~~~~~~~~~~~~~~~~~~~~~..............WWWWWWWWWWWWWWWWWWWWWWWWWWWWWWWWWAAAAAAAAAAAAA,,,,,,,,,,,,,,,,,,,,,,,,,,,,,,,AAAAAAAAAAAAAAAAAAAAAAAAAAAAAAAAAWWWWWWWWWWWWWWWW,WW,,,,,,,,,,,,,,,W,WWWWWWWWWWWWWWW",
        "~~~~~~~~~~~~~~~~~~~~~~~~...............WWWWWWWWWWWWWWWWWWWWWWWWWWWWWWWWWAAAAAAAAAAAAA,,,,,,,,,,,,,,,,,,,,,,,,,,,,,AAAAAAAAAAAAAAAAAAAAAAAAAAAAAAAAAWWWWWWWWWWWWWWWWW,,W,,,,,,,,,,,,,,,,,WW,WWWWWWWWWWWWW",
        "~~~~~~~~~~~~~~~~~~~~~~~~................,,,WWWWWWWWWWWWWWWWWWWWWWWWWWWWWAAAAAAAAAAAAAA,,,,,,,,,,,,,,,,,,,,,,,,,,AAAAAAAAAAAAAAAAAAAAAAAAAAAAAAAAAWWWWWWWWWWWWWWWWWW,WW,,,,,,,,,,,,,,,,,,W,WWWWWWWWWWWWWW",
        "~~~~~~~~~~~~~~~~~~~~~~~~..................,,,,,WWWWWWWWWWWWWWWWWWWWWWWW/AAAAAAAAAAAAAAA,,,,,,,,,,,,,,,,,,,,,,AAAAAAAAAAAAAAAAAAAAAAAAAAAAAAAAAAWWWWWWWWWWWWWWWWWWWW,W,,,,,,,,,,,,,,,,,,,,W,WW,WWWWWWWWWW",
        "~~~~~~~~~~~~~~~~~~~~~~~~..................,,,,,,,,,,,,,,,,,,,,,,,,,,AAA|AAAAAAAAAAAAAAAAAA,,,,,,,,,,,,,,,AAAAAAAAAAAAAAAAAAAAAAAAAAAAAAAAAAAAWWWWWWWWWWWWWWWWWW,,WW,,,,,,,,,,,,,,,,,,,,,,,,WW,WWWWWWWWWW",
        "~~~~~~~~~~~~~~~~~~~~~~~~..............,,,,,,,,,,,,,,,,,,,,,AAAAA,AAAAAA|AAAAAAAAAAAAAAAAAAAAAAAAAAAAAAAAAAAAAAAAAAAAAAAAAAAAAAAAAAAAAAAAAAAA/AAAAAAAAAAA,AAA,AAA,,A,,AAA,,,AAAAA,A,AAA,AAAAAAAAAAAAAAAAA",
        "~~~~~~~~~~~~~~~~~~~~~~~~................,,,,,,,,,,,,,AA,,,A,,,AAAA,,AAA|AAAAAAAAAAAAAAAAAAAAAAAAAAAAAAAAAAAAAAAAAAAAAAAAAAAAAAAAAAAAAAAAAA/AAAAAAAAAAA,AAAAA,AA,,,,AAAAA,AAAAAAAAAAAAAAAAAA,AAAAAAAAAAAA",
        "~~~~~~~~~~~~~~~~~~~~~~~...................,,,,,,,,,,,,,AA,,,AAAAAAAAAAA|AAAAAAAAAAAAAAAAAAAAAAAAAAAAAAAAAAAAAAAAAAAAAAAAAAAAAAAAAAAAAAAA/AAAAAAAAA,AAAAAA,AAAA,,AAAAA,,AAA,AAAAAAAA,AA,AAAAAAAAAAAAAAAAA",
        "~~~~~~~~~~~~~~~~~~~~~~~.................,,,,,,,,,,,,,,,,A,,,,,,AA,AAAAA|AAAAAAAAAAAAAAAAAAAAAAAAAAAAAAAAAAAAAAAAAAAAAAAAAAAAAAAAAAAAAA/AAAAAAAAAAAAAAAAAAAAAAAAAAA,A,AA,AAAAAAAAAAAAAAAAAA,AAAAAAAAAAAAA",
        "~~~~~~~~~~~~~~~~~~~~~~~.................,,,,,,,,,,,,,,,AA,,,,,,AAAAAAAA|AAAAAAAAAAAAAAAAAAAAAAAAAAAAAAAAAAAAAAAAAAAAAAAAAAAAAAAAAAAA/AAAAAAAAAAAAAAAAAA,AAAAAAAAA,AAAAAAAAAAAAAAAAAAAAAAAAAAAAAAAAAAAAAA",
        "~~~~~~~~~~~~~~~~~~~~~~~....................,,,,,,,,,,,,,,,,,,AAA,AAAAAA|AAAAAAAAAAAAAAAAAAAAAAAAAAAAAAAAAAAAAAAAAAAAAAAAAAAAAAAAAA/AAAAAAAAAAAAAAAAAAAAAAAAA,AA,AAAAAAAA,AAAAAAAAAA,AAAAAAAAAAAAAAAAAAAA",
        "~~~~~~~~~~~~~~~~~~~~~~~.................,,,,,,,,,,,A,,A,,AAAAAAA,,AAAAA|AAAAAAAAAAAAAAAAAAAAAAAAAAAAAAAAAAAAAAAAAAAAAAAAAAAAAAAA/AAAAAAAAAAAAAAAAAAAAAAAAAAAAAAAAAAAAAAAAAAAAAAAAAAAAAAAAAAAAAAAAAAAAAAA",
        "~~~~~~~~~~~~~~~~~~~~~~~....................,,,,,,,,,,,AAAA,,,,AAAAAAAAA|AAAAAAAAAAAAAAAAAAAAAAAAAAAAAAAAAAAAAAAAAAAAAAAAAAAAAA/AAAAAAAAAAAAAAAAAAAAAAAAAAAAAAAAAAAAAAAAAAAAAAAAAAAAAAAAAAAAAAAAAAAAAAAAA",
        "~~~~~~~~~~~~~~~~~~~~~~~.................,,,,,,,,,,,,,,,,,A,,AAAAAA,,AAA|AAAAAAAAAAAAAAAAAAAAAAAAAAAAAAAAAAAAAAAAAAAAAAAAAAAA/AAAAAAAAAAAAAAAAAAAAAAAAAAAAAAAAAAAAAAAAAAAAAAAAAAAAAAAAAAAAAAAAAAAAAAAAAAA",
        "~~~~~~~~~~~~~~~~~~~~~~~.................,,,,,,,,,,,,,,,,,,,,,,,,AAAAAAA|AAAAAAAAAAAAAAAAAAAAAAAAAAAAAAAAAAAAAAAAAAAAAAAAAA/AAAAAAAAAAAAAAAAAAAAAAAAAAAAAAAAAAAAAAAAAAAAAAAAAAAAAAAAAAAAAAAAAAAAAAAAAAAAA",
        "~~~~~~~~~~~~~~~~~~~~~~~....................,,,,,,,,,,,,,,,,,AAA,AAAA,AA|AAAAAAAAAAAAAAAAAAAAAAAAAAAAAAAAAAAAAAAAAAAAAAAA/AAAAAAAAAAAAAAAAAAAAAAAAAAAAAAAAAAAAAAAAAAAAAAAAAAAAAAAAAAAAAAAAAAAAAAAAAAAAAAA",
        "~~~~~~~~~~~~~~~~~~~~~~~....................,,,,,,,,,,,,,,,,,,,,,A,,AAAA|AAAAAAAAAAAAAAAAAAAAAAAAAAAAAAAAAAAAAAAAAAAAAA/AAAAAAAAAAAAAAAAAAAAAAAAAAAAAAAAAAAAAAAAAAAAAAAAAAAAAAAAAAAAAAAAAAAAAAAAAAAAAAAAA",
        "~~~~~~~~~~~~~~~~~~~~~~~......................,,WWWWWWWWWWWWWWWWWWWWWWWWWWWWWWWWWWWA------------------------------AWWWWWWWWWWWWWWWWWWWWWWWWWWWWWWWWWWWWWWWWWWWWWWWWWWWWWWWWWWWWWWWWWWWWWWWWWWWWWWWWWWWWWW",
        "~~~~~~~~~~~~~~~~~~~~~~~.....................WWWWWWWWWWWWWWWWWWWWWWWWWWWWWWWWWWWWAAAAAAAAAAAAAAAAAAAAAAAAAAAAAAAAWWWWWWWWWWWWWWWWWWWWWWWWWWWWWWWWWWWWWWWWWWWWWWWWWWWWWWWWWWWWWWWWWWWWWWWWWWWWWWWWWWWWWWWW",
        "~~~~~~~~~~~~~~~~~~~~~~~....................WWWWWWWWWWWWWWWWWWWWWWWWWWWWWWWWWWAAAAAAAAAAAAAAAAAAAAAAAAAAAAAAAAAWWWWWWWWWWWWWWWWWWWWWWWWWWWWWWWWWWWWWWWWWWWWWWWWWWWWWWWWWWWWWWWWWWWWWWWWWWWWWWWWWWWWWWWWWW"
    ],
    "tileSize": 1.2,
    "bgTileType": "~",
    "startPoints": [
        [116.5, 107.5, -90],
        [115.5, 104.5, -90],
        [110.5, 107.5, -90],
        [109.5, 104.5, -90],
        [104.5, 107.5, -90],
        [103.5, 104.5, -90]
    ],
    "raceLines": [
        {
            "mapX": 120.5,
            "mapY": 105.5,
            "length": 10,
            "rotation": 0
        },
        {
            "mapX": 175.5,
            "mapY": 97.5,
            "length": 15,
            "rotation": 90
        },
        {
            "mapX": 170.5,
            "mapY": 45.5,
            "length": 22,
            "rotation": 90
        }
    ],
    "oilSpills": [
        [126.5, 104.5, 1, 90]
    ],
    "boosts": [
        [126.5, 107.5, 10],
        [127.5, 107.5, 10],
        [128.5, 107.5, 10],
        [129.5, 107.5, 10]
    ],
    "boxes": [
        [126.5, 100.5, 2, 90]
    ],
    "tireStacks": [
        [126.5, 97.5]
    ]
}