{
    "width": 200,
    "height": 112,
    "tileLayout": [
        "~~~~~~~~~~~~~~~~~~~~WWWWWWWWWWWWWWWWWWWWWWWWWWWWWWWWWWWWWWWWWWWWWWWWWWWWWWWWWWWWWWWWWWWWWWWWWWWWWWWWWWWWWWWWWWWWWWWWWWWWWWWWWWWWWWWWWWWWWWWWWWWWWWWWWWWWWWWWWWWWWWWWWWWWWWWWW,,,,,,,,,,,,,,,,,,,,,,,,,,,",
        "~~~~~~~~~~~~~~~~~~~~~WWWWWWWWWWWWWWWWWWWWWWWWWWWWWWWWWWWWWWWWWWWWWWWWWWWWWWWWWWWWWWWWWWWWWWWWWWWWWWWWWWWWWWWWWWWWWWWWWWWWWWWWWWWWWWWWWWWWWWWWWWWWWWWWWWWWWWWWWWWWWWWWWWWWW,,,,,,,,,,,,,,,,,,,,,,,,,,,,,,",
        "~~~~~~~~~~~~~~~~~~~~~WWWWWWWWWWWWWWWWWWWWWWWWWWWWWWWWW/-----------------------------------------------------------------#--------------------------------------WWWWWW,,,,,,,,,,,,,,,,,,,,,,,,,,,,,,,,,,,",
        "~~~~~~~~~~~~~~~~~~~~~~WWWWWWWWWWWWWWWWWWWWWWWWWWWWW/-/AAAAAAAAAAAAAAAAAAAAAAAAAAAAAAAAAAAAAAAAAAAAAAAAAAAAAAAAAAAAAAAAAA#AAAAAAAAAAAAAAAAAAAAAAAAAAAAAAAAAAAAAAAAAAAAA,,,,,,,,,,,,,,,,,,,,,,,,,,,,,,,,,,",
        "~~~~~~~~~~~~~~~~~~~~~~WWWWWWWWWWWWWWWWWWWWWWWW/---/AAAAAAAAAAAAAAAAAAAAAAAAAAAAAAAAAAAAAAAAAAAAAAAAAAAAAAAAAAAAAAAAAAAAA#AAAAAAAAAAAAAAAAAAAAAAAAAAAAAAAAAAAAAAAAAAAAAAAAAA,,,,,,,,,,,,,,,,,,,,,,,,,,,,,",
        "~~~~~~~~~~~~~~~~~~~~~~WWWWWWWWWWWWWWWWWWW/---/AAAAAAAAAAAAAAAAAAAAAAAAAAAAAAAAAAAAAAAAAAAAAAAAAAAAAAAAAAAAAAAAAAAAAAAAAA#AAAAAAAAAAAAAAAAAAAAAAAAAAAAAAAAAAAAAAAAAAAAAAAAAAAAA,,,,,,,,,,,,,,,,,,,,,,,,,,",
        "~~~~~~~~~~~~~~~~~~~~~~WWWWWWWWWWWWWWWWWW/AAAAAAAAAAAAAAAAAAAAAAAAAAAAAAAAAAAAAAAAAAAAAAAAAAAAAAAAAAAAAAAAAAAAAAAAAAAAAAA#AAAAAAAAAAAAAAAAAAAAAAAAAAAAAAAAAAAAAAAAAAAAAAAAAAAAAAA,,,,,,,,,,,,,,,,,,,,,,,,",
        "~~~~~~~~~~~~~~~~~~~~~~WWWWWWWWWWWWWWWWWW|AAAAAAAAAAAAAAAAAAAAAAAAAAAAAAAAAAAAAAAAAAAAAAAAAAAAAAAAAAAAAAAAAAAAAAAAAAAAAAA#AAAAAAAAAAAAAAAAAAAAAAAAAAAAAAAAAAAAAAAAAAAAAAAAAAAAAAAA,,,,,,,,,,,,,,,,,,,,,,,",
        "~~~~~~~~~~~~~~~~~~~~~~WWWWWWWWWWWWWWWWWW/AAAAAAAAAAAAAAAAAAAAAAAAAAAAAAAAAAAAAAAAAAAAAAAAAAAAAAAAAAAAAAAAAAAAAAAAAAAAAAA#AAAAAAAAAAAAAAAAAAAAAAAAAAAAAAAAAAAAAAAAAAAAAAAAAAAAAAAAAA,,,,,,,,,,,,,,,,,,,,,",
        "~~~~~~~~~~~~~~~~~~~~~~~WWWWWWWWWWWWWWWW/AAAAAAAAAAAAAAAAAAAAAAAAAAAAAAAAAAAAAAAAAAAAAAAAAAAAAAAAAAAAAAAAAAAAAAAAAAAAAAAA#AAAAAAAAAAAAAAAAAAAAAAAAAAAAAAAAAAAAAAAAAAAAAAAAAAAAAAAAAAAA,,,,,,,,,,,,,,,,,,,",
        "~~~~~~~~~~~~~~~~~~~~~~~WWWWWWWWWWWWWWW/AAAAAAAAAAAAAAAAAAAAAAAA/--------------------------------------------------------#------------------------------AAAAAAAAAAAAAAAAAAAAAAAAAAAAAAA,,,,,,,,,,,,,,,,,,",
        "~~~~~~~~~~~~~~~~~~~~~~~~~WWWWWWWWWWWWW|AAAAAAAAAAAAAAAAAAAAAAA/WWWWWWWWWWWWWWWWWWWWWWWWWWWWWWWWWWWWWWWWWWWWWWWWWWWWWWWWWWWWWWWWWWWWWWWWWWWWWWWWWWWWWWWWAAAAAAAAAAAAAAAAAAAAAAAAAAAAAAA,,,,,,,,,,,,,,,,,,",
        "~~~~~~~~~~~~~~~~~~~~~~~~~~WWWWWWWWWWWW|AAAAAAAAAAAAAAAAAAAA/-/WWWWWWWWWWWWWWWWWWWWWWWWWWWWWWWWWWWWWWWWWWWWWWWWWWWWWWWWWWWWWWWWWWWWWWWWWWWWWWWWWWWWWWWWWWWWWWWWWWAAAAAAAAAAAAAAAAAAAAAAA,,,,,,,,,,,,,,,,,",
        "~~~~~~~~~~~~~~~~~~~~~~~~~~~WWWWWWWWWWW|AAAAAAAAAAAAAAAAAAA/WWWWWWWWWWWWWWWWWWWWWWWWWWWWWWWWWWWWWWWWWWWWWWWWWWWWWWWWWWWWWWWWWWWWWWWWWWWWWWWWWWWWWWWWWWWWWWWWWWWWWWWWWWAAAAAAAAAAAAAAAAAA,,,,,,,,,,,,,,,,,",
        "~~~~~~~~~~~~~~~~~~~~~~~~~~~~WWWWWWWWWW|AAAAAAAAAAAAAAAAAAA|WWWWWWWWWWWWWWWWWWWWWWWWWWWWWWWWWWWWWWWWWWWWWWWWWWWWWWWWWWWWWWWWWWWWWWWWWWWWWWWWWWWWWWWWWWWWWWWWWWWWWWWWWWWWWAAAAAAAAAAAAAAA,,,,,,,,,,,,,,,,,",
        "~~~~~~~~~~~~~~~~~~~~~~~~~~~~WWWWWWWWWW|AAAAAAAAAAAAAAAAAAA|WWWWWWWWWWWWWWWWWWWWWWWWWWWWWWWWWWWWWWWWWWWWWWWWWWWWWWWWWWWWWWWWWWWWWWWWWWWWWWWWWWWWWWWWWWWWWWWWWWWWWWWWWWWWWWAAAAAAAAAAAAAAAA,,,,,,,,,,,,,,,",
        "~~~~~~~~~~~~~~~~~~~~~~~~~~~~~~WWWWWWWW|AAAAAAAAAAAAAAAAAAAAAWWWWWWWWWWWWWWWWWWWWWWWWWWWWWWWWWWWWWWWWWWWWWWWWWWWWWWWWWWWWWWWWWWWWWWWWWWWWWWWWWWWWWWWWWWWWWWWWWWWWWWWWWWWWWWWAAAAAAAAAAAAAA,,,,,,,,,,,,,,,",
        "~~~~~~~~~~~~~~~~~~~~~~~~~~~~~~WWWWWWWWAAAAAAAAAAAAAAAAAAAAAAAWWWWWWWWWWWWWWWWWWWWWWWWWWWWWWWWWWWWWWWWWWWWWWWWWWWWWWWWWWWWWWWWWWWWWWWWWWWWWWWWWWWWWWWWWWWWWWWWWWWWWWWWWWWWWWAAAAAAAAAAAAAA,,,,,,,,,,,,,,,",
        "~~~~~~~~~~~~~~~~~~~~~~~~~~~~~~~WWWWWWWAAAAAAAAAAAAAAAAAAAAAAAAAAWWWWWWWWWWWWWWWWWWWWAAAAAAAAAAAAAAAAAAAAAAAAAAAAAAAAAAAWWWWWWWWWWWWWWWWWWWWWWWWWWWWWWWWWWWWWWWWWWWWWWWWWWWWAAAAAAAAAAAAAA,,,,,,,,,,,,,,,",
        "~~~~~~~~~~~~~~~~~~~~~~~~~~~~~~~~WWWWWWWAAAAAAAAAAAAAAAAAAAAAAAAAAAAAAAAAAAAAAAAAAAAAAAAAAAAAAAAAAAAAAAAAAAAAAAAAAAAAAAAAAAAAWWWWWWWWWWWWWWWWWWWWWWWWWWWWWWWWWWWWWWWWWWWWWWWWAAAAAAAAAAAAAAA,,,,,,,,,,,,,",
        "~~~~~~~~~~~~~~~~~~~~~~~~~~~~~~~~WWWWWWWAAAAAAAAAAAAAAAAAAAAAAAAAAAAAAAAAAAAAAAAAAAAAAAAAAAAAAAAAAAAAAAAAAAAAAAAAAAAAAAAAAAAAAAAWWWWWWWWWWWWWWWWWWWWWWWWWWWWWWWWWWWWWWWWWWWWWAAAAAAAAAAAAAAA,,,,,,,,,,,,,",
        "~~~~~~~~~~~~~~~~~~~~~~~~~~~~~~~~~~~WWWWWAAAAAAAAAAAAAAAAAAAAAAAAAAAAAAAAAAAAAAAAAAAAAAAAAAAAAAAAAAAAAAAAAAAAAAAAAAAAAAAAAAAAAAAAAWWWWWWWWWWWWWWWWWWWWWWWWWWWWWWWWWWWWWWWWWWWAAAAAAAAAAAAAAA,,,,,,,,,,,WW",
        "~~~~~~~~~~~~~~~~~~~~~~~~~~~~~~~~~~~~WWWWAAAAAAAAAAAAAAAAAAAAAAAAAAAAAAAAAAAAAAAAAAAAAAAAAAAAAAAAAAAAAAAAAAAAAAAAAAAAAAAAAAAAAAAAAAWWWWWWWWWWWWWWWWWWWWWWWWWWWWWWWWWWWWWWWWWWAAAAAAAAAAAAAAA,,,,,,,,WWWWW",
        "~~~~~~~~~~~~~~~~~~~~~~~~~~~~~~~~~~~~~WWWWWAAAAAAAAAAAAAAAAAAAAAAAAAAAAAAAAAAAAAAAAAAAAAAAAAAAAAAAAAAAAAAAAAAAAAAAAAAAAAAAAAAAAAAAAAWWWWWWWWWWWWWWWWWWWWWWWWWWWWWWWWWWWWWWWWWAAAAAAAAAAAAAAA,,,,,,WWWWWWW",
        "~~~~~~~~~~~~~~~~~~~~~~~~~~~~~~~~~~~~~~WWWWWWWAAAAAAAAAAAAAAAAAAAAAAAAAAAAAAAAAAAAAAAAAAAAAAAAAAAAAAAAAAAAAAAAAAAAAAAAAAAAAAAAAAAAAAWWWWWWWWWWWWWWWWWWWWWWWWWWWWWWWWWWWWWWWWWAAAAAAAAAAAAAAA,,,,WWWWWWWWW",
        "~~~~~~~~~~~~~~~~~~~~~~~~~~~~~~~~~~~~~~~WWWWWWWWAAAAAAAAAAAAAAAAAAAAAAAAAAAAAAAAAAAAAAAAAAAAAAAAAAAAAAAAAAAAAAAAAAAAAAAAAAAAAAAAAAAAAWWWWWWWWWWWWWWWWWWWWWWWWWWWWWWWWWWWWWWWWAAAAAAAAAAAAAAAAWWWWWWWWWWWW",
        "~~~~~~~~~~~~~~~~~~~~~~~~~~~~~~~~~~~~~~~~WWWWWWWWWAAAAAAAAAAAAAAAAAAAAAAAAAAAAAAAAAAAAAAAAAAAAAAAAAAAAAAAAAAAAAAAAAAAAAAAAAAAAAAAAAAAAWWWWWWWWWWWWWWWWWWWWWWWWWWWWWWWWWWWWWWWWAAAAAAAAAAAAAAAWWWWWWWWWWWW",
        "~~~~~~~~~~~~~~~~~~~~~~~~~~~~~~~~~~~~~~~~WWWWWWWWWWWWAAAAAAAAAAAAAAAAAAAAAAAAAAAAWWWWWWWWWWWWWWWWWWWWWWWWW,,,,,,,,,AAAAAAAAAAAAAAAAAAAWWWWWWWWWWWWWWWWWWWWWWWWWWWWWWWWWWWWWWWWAAAAAAAAAAAAAAAWWWWWWWWWWWW",
        "~~~~~~~~~~~~~~~~~~~~~~~~~~~~~~~~~~~~~~~~~WWWWWWWWWWWWWWWWWWWWWWWWWWWWWWWWWWWWWWWWWWWWWWWWWWWWWWWWWWWWWWWWWWW,,,,,,,,,AAAAAAAAAAAAAAAAWWWWWWWWWWWWWWWWWWWWWWWWWWWWWWWWWWWWWWWWAAAAAAAAAAAAAAAWWWWWWWWWWWW",
        "~~~~~~~~~~~~~~~~~~~~~~~~~~~~~~~~~~~~~~~~~WWWWWWWWWWWWWWWWWWWWWWWWWWWWWWWWWWWWWWWWWWWWWWWWWWWWWWWWWWWWWWWWWWWWWW,,,,,,,AAAAAAAAAAAAAAAAWWWWWWWWWWWWWWWWWWWWWWWWWWWWWWWWWWWWWWWAAAAAAAAAAAAAAAWWWWWWWWWWWW",
        "~~~~~~~~~~~~~~~~~~~~~~~~~~~~~~~~~~~~~~~~~~WWWWWWWWWWWWWWWWWWWWWWWWWWWWWWWWWWWWWWWWWWWWWWWWWWWWWWWWWWWWWWWWWWWWWW,,,,,,AAAAAAAAAAAAAAAAWWWWWWWWWWWWWWWWWWWWWWWWWWWWWWWWWWWWWWWAAAAAAAAAAAAAAAWWWWWWWWWWWW",
        "~~~~~~~~~~~~~~~~~~~~~~~~~~~~~~~~~~~~~~~~~~~~WWWWWWWWWWWWWWWWWWWWWWWWWWWWWWWWWWWWWWWWWWWWWWWWWWWWWWWWWWWWWWWWWWWWW,,,,,,AAAAAAAAAAAAAAAWWWWWWWWWWWWWWWWWWWWWWWWWWWWWWWWWWWWWWWWAAAAAAAAAAAAAAWWWWWWWWWWWW",
        "~~~~~~~~~~~~~~~~~~~~~~~~~~~~~~~~~~~~~~~~~~~~WWWWWWWWWWWWWWWWWWWWWWWWWWWWWWWWWWWWWWWWWWWWWWWWWWWWWWWWWWWWWWWWWWWWW,,,,,,AAAAAAAAAAAAAAAWWWWWWWWWWWWWWWWWWWWWWWWWWWWWWWWWWWWWWWWAAAAAAAAAAAAAAWWWWWWWWWWWW",
        "~~~~~~~~~~~~~~~~~~~~~~~~~~~~~~~~~~~~~~~~~~~~~WWWWWWWWWWWWWWWWWWWWWWWWWWWWWWWW,,,,,,,,,,,,,,WWWWWWWWWWWWWWWWWWWWWW,,,,,,AAAAAAAAAAAAAAAWWWWWWWWWWWWWWWWWWWWWWWWWWWWWWWWWWWWWWWWAAAAAAAAAAAAAAWWWWWWWWWWWW",
        "~~~~~~~~~~~~~~~~~~~~~~~~~~~~~~~~~~~~~~~~~~~~~~WWWWWWWWWWWWWWWWWWWWWWWW,,,,,,,,,,,,,,,,,,,,,,,,,,WWWWWWWWWWWWWWWWW,,,,,,AAAAAAAAAAAAAAAWWWWWWWWWWWWWWWWWWWWWWWWWWWWWWWWWWWWWWWWAAAAAAAAAAAAAAWWWWWWWWWWWW",
        "~~~~~~~~~~~~~~~~~~~~~~~~~~~~~~~~~~~~~~~~~~~~~~WWWWWWWWWWWWWWWWWWWW,,,,,,,,,,,,,,,,,,,,,,,,,,,,,,,,,,,,WWWWWWWWWW,,,,,,,AAAAAAAAAAAAAAWWWWWWWWWWWWWWWWWWWWWWWWWWWWWWWWWWWWWWWWWWAAAAAAAAAAAAAWWWWWWWWWWWW",
        "~~~~~~~~~~~~~~~~~~~~~~~~~~~~~~~~~~~~~~~~~~~~~~WWWWWWWWWWWWWWW,,,,,,,,,,,,,,,,,,,,,,,,,,,,,,,,,,,,,WWWWWWWWWWWWWW,,,,,,AAAAAAAAAAAAAAAWWWWWWWWWWWWWWWWWWWWWWWWWWWWWWWWWWWWWWWWWWAAAAAAAAAAAAAWWWWWWWWWWWW",
        "~~~~~~~~~~~~~~~~~~~~~~~~~~~~~~~~~~~~~~~~~~~~~~~~WWWWWWWWW,,,,,,,,,,,,,,,,,,,,,,,,,,,,,,,,,,WWWWWWWWWWWWWWWWWWWW,,,,,,AAAAAAAAAAAAAAAAWWWWWWWWWWWWWWWWWWWWWWWWWWWWWWWWWWWWWWWWWWAAAAAAAAAAAAAWWWWWWWWWWWW",
        "~~~~~~~~~~~~~~~~~~~~~~~~~~~~~~~~~~~~~~~~~~~~~~~~WWWWWWWWWW,,,,,,,,,,,,,,,,,,,,,,,,,,,,,,,WWWWWWWWWWWWWWWWWWWWWW,,,,,AAAAAAAAAAAAAAAAAWWWWWWWWWWWWWWWWWWWWWWWWWWWWWWWWWWWWWWWWWWAAAAAAAAAAAAAWWWWWWWWWWWW",
        "~~~~~~~~~~~~~~~~~~~~~~~~~~~~~~~~~~~~~~~~~~~~~~~~WWWWWWWWWWWWW,,,,,,,,,,,,,,,,,,WWWWWWWWWWWWWWWWWWWWWWWWWWWWWWW,,,,,AAAAAAAAAAAAAAAAAWWWWWWWWWWWWWWWWWWWWWWWWWWWWWWWWWWWWWWWWWWWAAAAAAAAAAAAAWWWWWWWWWWWW",
        "~~~~~~~~~~~~~~~~~~~~~~~~~~~~~~~~~~~~~~~~~~~~~~~~WWWWWWWWWWWWWWWWWWWWWW,,,,WWWWWWWWWWWWWWWWWWWWWWWWWWWWWWWWWWW,,,,,AAAAAAAAAAAAAAAAAAWWWWWWWWWWWWWWWWWWWWWWWWWWWWWWWWWWWWWWWWWWWAAAAAAAAAAAAAWWWWWWWWWWWW",
        "~~~~~~~~~~~~~~~~~~~~~~~~~~~~~~~~~~~~~~~~~~~~~~~~WWWWWWWWWWWWWWWWWWWWWWWWWWWWWWWWWWWWWWWWWWWWWWWWWWWWWWWWWWWW,,,,AAAAAAAAAAAAAAAAAAAAWWWWWWWWWWWWWWWWWWWWWWWWWWWWWWWWWWWWWWWWWWWAAAAAAAAAAAAWWWWWWWWWWWWW",
        "~~~~~~~~~~~~~~~~~~~~~~~~~~~~~~~~~~~~~~~~~~~~~~~WWWWWWWWWWWWWWWWWWWWWWWWWWWWWWWWWWWWWWWWWWWWWWWWWWWWWWWWWWWW,,,AAAAAAAAAAAAAAAAAAAAAWWWWWWWWWWWWWWWWWWWWWWWWWWWWWWWWWWWWWWWWWWWWAAAAAAAAAAAAWWWWWWWWWWWWW",
        "~~~~~~~~~~~~~~~~~~~~~~~~~~~~~~~~~~~~~~~~~~~~~~~WWWWWWWWWWWWWWWWWWWWWWWWWWWWWWWWWWWWWWWWWWWWWWWWWWWWWWWWWW,,,,AAAAAAAAAAAAAAAAAAAAAWWWWWWWWWWWWWWWWWWWWWWWWWWWWWWWWWWWWWWWWWWWWAAAAAAAAAAAAAWWWWWWWWWWWWW",
        "~~~~~~~~~~~~~~~~~~~~~~~~~~~~~~~~~~~~~~~~~~~~~~~WWWWWWWWWWWWWWWWWWWWWWWWWWWWWWWWWWWWWWWWWWWWWWWWWWWWWWWWAAAAAAAAAAAAAAAAAAAAAAAAAAAWWWWWWWWWWWWWWWWWWWWWWWWWWWWWWWWWWWWWWWWWWWWAAAAAAAAAAAAAWWWWWWWWWWWWW",
        "~~~~~~~~~~~~~~~~~~~~~~~~~~~~~~~~~~~~~~~~~~~~~~~WWWWWWWWWWWWWWWWWWWWWWWWWWWWWWWWWWWWWWWWWWWWWWWWWWWWAAAAAAAAAAAAAAAAAAAAAAAAAAAAAAWWWWWWWWWWWWWWWWWWWWWWWWWWWWWWWWWWWWWWWWWWWWWAAAAAAAAAAAAAWWWWWWWWWWWWW",
        "~~~~~~~~~~~~~~~~~~~~~~~~~~~~~~~~~~~~~~~~~~~~~~~WWWWWWWWWWWWWWWWWWWWWWWWWWWWWWWWWWWWWWWWWWWWWWAAAAAAAAAAAAAAAAAAAAAAAAAAAAAAAAAAAWWWWWWWWWWWWWWWWWWWWWWWWWWWWWWWWWWWWWWWWWWWWWWAAAAAAAAAAAAAWWWWWWWWWWWWW",
        "~~~~~~~~~~~~~~~~~~~~~~~~~~~~~~~~~~~~~~~~~~~~~~~WWWWWWWWWWWWWWWWWWWWWWWWWWWWWWWWWWWWWWWWWAAAAAAAAAAAAAAAAAAAAAAAAAAAAAAAAAAAAAAWWWWWWWWWWWWWWWWWWWWWWWWWWWWWWWWWWWWWWWWWWWWWWWWAAAAAAAAAAAAAWWWWWWWWWWWWW",
        "~~~~~~~~~~~~~~~~~~~~~~~~~~~~~~~~~~~~~~~~~~~~~~~WWWWWWWWWWWWWWWWWWWWWWWWWWWWWWWWWWWWAAAAAAAAAAAAAAAAAAAAAAAAAAAAAAAAAAAAAAAAAAWWWWWWWWWWWWWWWWWWWWWWWWWWWWWWWWWWWWWWWWWWWWWWWWAAAAAAAAAAAAAAWWWWWWWWWWWWW",
        "~~~~~~~~~~~~~~~~~~~~~~~~~~~~~~~~~~~~~~~~~~~~~~~WWWWWWWWWWWWWWWWWWWWWWWWWWWWWWWWAAAAAAAAAAAAAAAAAAAAAAAAAAAAAAAAAAAAAAAAAAAAAWWWWWWWWWWWWWWWWWWWWWWWWWWWWWWWWWWWWWWWWWWWWWWWWWAAAAAAAAAAAAAWWWWWWWWWWWWWW",
        "~~~~~~~~~~~~~~~~~~~~~~~~~~~~~~~~~~~~~~~~~~~~~~~~WWWWWWWWWWWWWWWWWWWWWWWWWWWWWAAAAAAAAAAAAAAAAAAAAAAAAAAAAAAAAAAAAAAAAAAAAAWWWWWWWWWWWWWWWWWWWWWWWWWWWWWWWWWWWWWWWWWWWWWWWWWWWAAAAAAAAAAAAAWWWWWWWWWWWWWW",
        "~~~~~~~~~~~~~~~~~~~~~~~~~~~~~~~~~~~~~~~~~~~~~~~~WWWWWWWWWWWWWWWWWWWWWWWWWWWAAAAAAAAAAAAAAAAAAAAAAAAAAAAAAAAAAAAAAAAAWWWWWWWWWWWWWWWWWWWWWWWWWWWWWWWWWWWWWWWWWWWWWWWWWWWWWWWWWAAAAAAAAAAAAAWWWWWWWWWWWWWW",
        "~~~~~~~~~~~~~~~~~~~~~~~~~~~~~~~~~~~~~~~~~~~~~~~~WWWWWWWWWWWWWWWWWWWWWWWWWWAAAAAAAAAAAAAAAAAAAAAAAAAAAAAAAAAAAAAAAWWWWWWWWWWWWWWWWWWWWWWWWWWWWWWWWWWWWWWWWWWWWWWWWWWWWWWWWWWWAAAAAAAAAAAAAAWWWWWWWWWWWWWW",
        "~~~~~~~~~~~~~~~~~~~~~~~~~~~~~~~~~~~~~~~~~~~~~~~~WWWWWWWWWWWWWWWWWWWWWWWWWAAAAAAAAAAAAAAAAAAAAAAAAAAAAAAAAAAAAAAWWWWWWWWWWWWWWWWWWWWWWWWWWWWWWWWWWWWWWWWWWWWWWWWWWWWWWWWWWWWWAAAAAAAAAAAAAAWWWWWWWWWWWWWW",
        "~~~~~~~~~~~~~~~~~~~~~~~~~~~~~~~~~~~~~~~~~~~~~~~~WWWWWWWWWWWWWWWWWWWWWWWWWAAAAAAAAAAAAAAAAAAAAAAAAAAAAAAWWWWWWWWWWWWWWWWWWWWWWWWWWWWWWWWWWWWWWWWWWWWWWWWWWWWWWWWWWWWWWWWWWWWWAAAAAAAAAAAAAWWWWWWWWWWWWWWW",
        "~~~~~~~~~~~~~~~~~~~~~~~~~~~~~~~~~~~~~~~~~~~~~~~~WWWWWWWWWWWWWWWWWWWWWWWWWAAAAAAAAAAAAAAAAAAAAAAAAAAWWWWWWWWWWWWWWWWWWWWWWWWWWWWWWWWWWWWWWWWWWWWWWWWWWWWWWWWWWWWWWWWWWWWWWWWAAAAAAAAAAAAAAWWWWWWWWWWWWWWW",
        "~~~~~~~~~~~~~~~~~~~~~~~~~~~~~~~~~~~~~~~~~~~~~~~~WWWWWWWWWWWWWWWWWWWWWWWWWAAAAAAAAAAAAAAAAAAAAAAAWWWWWWWWWWWWWWWWWWWWWWWWWWWWWWWWWWWWWWWWWWWWWWWWWWWWWWWWWWWWWWWWWWWWWWWWWWWAAAAAAAAAAAAAAWWWWWWWWWWWWWWW",
        "~~~~~~~~~~~~~~~~~~~~~~~~~~~~~~~~~~~~~~~~~~~~~~~~WWWWWWWWWWWWWWWWWWWWWWWWWAAAAAAAAAAAAAAAAAAWWWWWWWWWWWWWWWWWWWWWWWWWWWWWWWWWWWWWWWWWWWWWWWWWWWWWWWWWWWWWWWWWWWWWWWWWWWWWWWWAAAAAAAAAAAAAAWWWWWWWWWWWWWWW",
        "~~~~~~~~~~~~~~~~~~~~~~~~~~~~~~~~~~~~~~~~~~~~~~~~WWWWWWWWWWWWWWWWWWWWWWWWWAAAAAAAAAAAAAAWWWWWWWWWWWWWWWWWWWWWWWWWWWWWWWWWWWWWWWWWWWWWWWWWWWWWWWWWWWWWWWWWWWWWWWWWWWWWWWWWWWAAAAAAAAAAAAAAAWWWWWWWWWWWWWWW",
        "~~~~~~~~~~~~~~~~~~~~~~~~~~~~~~~~~~~~~~~~~~~~~~~~WWWWWWWWWWWWWWWWWWWWWWWWAAAAAAAAAAAAAAWWWWWWWWWWWWWWWWWWWWWWWWWWWWWWWWWWWWWWWWWWWWWWWWWWWWWWWWWWWWWWWWWWWWWWWWWWWWWWWWWWWWAAAAAAAAAAAAAAWWWWWWWWWWWWWWWW",
        "~~~~~~~~~~~~~~~~~~~~~~~~~~~~~~~~~~~~~~~~~~~~~~~~WWWWWWWWWWWWWWWWWWWWWWWWAAAAAAAAAAAAAAWWWWWWWWWWWWWWWWWWWWWWWWWWWWWWWWWWWWWWWWWWWWWWWWWWWWWWWWWWWWWWWWWWWWWWWWWWWWWWWWWWWAAAAAAAAAAAAAAAWWWWWWWWWWWWWWWW",
        "~~~~~~~~~~~~~~~~~~~~~~~~~~~~~~~~~~~~~~~~~~~~~~~WWWWWWWWWWWWWWWWWWWWWWWWWAAAAAAAAAAAAAAWWWWWWWWWWWWWWWWWWWWWWWWWWWWWWWWWWWWWWWWWWWWWWWWWWWWWWWWWWWWWWWWWWWWWWWWWWWWWWWWWWWAAAAAAAAAAAAAAAWWWWWWWWWWWWWWWW",
        "~~~~~~~~~~~~~~~~~~~~~~~~~~~~~~~~~~~~~~~~~~~~~~~WWWWWWWWWWWWWWWWWWWWWWWWWAAAAAAAAAAAAAWWWWWWWWWWWWWWWWWWWWWWWWWWWWWWWWWWWWWWWWWWWWWWWWWWWWWWWWWWWWWWWWWWWWWWWWWWWWWWWWWWWWAAAAAAAAAAAAAAAWWWWWWWWWWWWWWWW",
        "~~~~~~~~~~~~~~~~~~~~~~~~~~~~~~~~~~~~~~~~~~~~~~WWWWWWWWWWWWWWWWWWWWWWWWWWAAAAAAAAAAAAAWWWWWWWWWWWWWWWWWWWWWWWWWWWWWWWWWWWWWWWWWWWWWWWWWWWWWWWWWWWWWWWWWWWWWWWWWWWWWWWWWWWAAAAAAAAAAAAAAAWWWWWWWWWWWWWWWWW",
        "~~~~~~~~~~~~~~~~~~~~~~~~~~~~~~~~~~~~~~~~~~~~~~WWWWWWWWWWWWWWWWWWWWWWWWWWAAAAAAAAAAAAAWWWWWWWWWWWWWWWWWWWWWWWWWWWWWWWWWWWWWWWWWWWWWWWWWWWWWWWWWWWWWWWWWWWWWWWWWWWWWWWWWWAAAAAAAAAAAAAAAAWWWWWWWWWWWWWWWWW",
        "~~~~~~~~~~~~~~~~~~~~~~~~~~~~~~~~~~~~~~~~~~~~~~WWWWWWWWWWWWWWWWWWWWWWWWWWAAAAAAAAAAAAAWWWWWWWWWWWWWWWWWWWWWWWWWWWWWWWWWWWWWWWWWWWWWWWWWWWWWWWWWWWWWWWWWWWWWWWWWWWWWWWWWWAAAAAAAAAAAAAAAAWWWWWWWWWWWWWWWWW",
        "~~~~~~~~~~~~~~~~~~~~~~~~~~~~~~~~~~~~~~~~~~~~.WWWWWWWWWWWWWWWWWWWWWWWWWWWAAAAAAAAAAAAAWWWWWWWWWWWWWWWWWWWWWWWWWWWWWWWWWWWWWWWWWWWWWWWWWWWWWWWWWWWWWWWWWWWWWWWWWWWWWWWWWAAAAAAAAAAAAAAAAWWWWWWWWWWWWWWWWWW",
        "~~~~~~~~~~~~~~~~~~~~~~~~~~~~~~~~~~~~~~~~~~~~.WWWWWWWWWWWWWWWWWWWWWWWWWWWAAAAAAAAAAAAAWWWWWWWWWWWWWWWWWWWWWWWWWWWWWWWWWWWWWWWWWWWWWWWWWWWWWWWWWWWWWWWWWWWWWWWWWWWWWWWWAAAAAAAAAAAAAAAAAWWWWWWWWWWWWWWWWWW",
        "~~~~~~~~~~~~~~~~~~~~~~~~~~~~~~~~~~~~~~~~~~~...WWWWWWWWWWWWWWWWWWWWWWWWWWAAAAAAAAAAAAAWWWWWWWWWWWWWWWWWWWWWWWWWWWWWWWWWWWWWWWWWWWWWWWWWWWWWWWWWWWWWWWWWWWWWWWWWWWWWWWAAAAAAAAAAAAAAAAAWWWWWWWWWWWWWWWWWWW",
        "~~~~~~~~~~~~~~~~~~~~~~~~~~~~~~~~~~~~~~~~~~~...WWWWWWWWWWWWWWWWWWWWWWWWWWAAAAAAAAAAAAAWWWWWWWWWWWWWWWWWWWWWWWWWWWWWWWWWWWWWWWWWWWWWWWWWWWWWWWWWWWWWWWWWWWWWWWWWWWWWAAAAAAAAAAAAAAAAAAAWWWWWWWWWWWWWWWWWWW",
        "~~~~~~~~~~~~~~~~~~~~~~~~~~~~~~~~~~~~~~~~~~....WWWWWWWWWWWWWWWWWWWWWWWWWWAAAAAAAAAAAAAWWWWWWWWWWWWWWWWWWWWWWWWWWWWWWWWWWWWWWWWWWWWWWWWWWWWWWWWWWWWWWWWWWWWWWWWWWWAAAAAAAAAAAAAAAAAAAAWWWWWWWWWWWWWWWWWWWW",
        "~~~~~~~~~~~~~~~~~~~~~~~~~~~~~~~~~~~~~~~~~~....WWWWWWWWWWWWWWWWWWWWWWWWWWAAAAAAAAAAAAAWWWWWWWWWWWWWWWWWWWWWWWWWWWWWWWWWWWWWWWWWWWWWWWWWWWWWWWWWWWWWWWWWWWWWWWWWAAAAAAAAAAAAAAAAAAAAAWWWWWWWWWWWWWWWWWWWWW",
        "~~~~~~~~~~~~~~~~~~~~~~~~~~~~~~~~~~~~~~~~~....WWWWWWWWWWWWWWWWWWWWWWWWWWWAAAAAAAAAAAAAWWWWWWWWWWWWWWWWWWWWWWWWWWWWWWWWWWWWWWWWWWWWWWWWWWWWWWWWWWWWWWWWWWWWWWWAAAAAAAAAAAAAAAAAAAAAAWWWWWWWWWWWWWWWWWWWWWW",
        "~~~~~~~~~~~~~~~~~~~~~~~~~~~~~~~~~~~~~~~~~....WWWWWWWWWWWWWWWWWWWWWWWWWWWAAAAAAAAAAAAAWWWWWWWWWWWWWWWWWWWWWWWWWWWWWWWWWWWWWWWWWWWWWWWWWWWWWWWWWWWWWWWWWWWWWAAAAAAAAAAAAAAAAAAAAAAAAWWWWWWWWWWWWWWWWWWWWWW",
        "~~~~~~~~~~~~~~~~~~~~~~~~~~~~~~~~~~~~~~~~~....WWWWWWWWWWWWWWWWWWWWWWWWWWWAAAAAAAAAAAAAWWWWWWWWWWWWWWWWWWWWWWWWWWWWWWWWWWWWWWWWWWWWWWWWWWWWWWWWWWWWWWWWWWWAAAAAAAAAAAAAAAAAAAAAAAAAWWWWWWWWWWWWWWWWWWWWWWW",
        "~~~~~~~~~~~~~~~~~~~~~~~~~~~~~~~~~~~~~~~~....WWWWWWWWWWWWWWWWWWWWWWWWWWWWAAAAAAAAAAAAAWWWWWWWWWWWWWWWWWWWWWWWWWWWWWWWWWWWWWWWWWWWWWWWWWWWWWWWWWWWWWWWWWAAAAAAAAAAAAAAAAAAAAAAAAAAAWWWWWWWWWWWWWWWWWWWWWWW",
        "~~~~~~~~~~~~~~~~~~~~~~~~~~~~~~~~~~~~~~~.....WWWWWWWWWWWWWWWWWWWWWWWWWWWWAAAAAAAAAAAAAWWWWWWWWWWWWWWWWWWWWWWWWWWWWWWWWWWWWWWWWWWWWWWWWWWWWWWWWWWWWWWWAAAAAAAAAAAAAAAAAAAAAAAAAAAAWWWWWWWWWWWWWWWWWWWWWWWW",
        "~~~~~~~~~~~~~~~~~~~~~~~~~~~~~~~~~~~~~~.....WWWWWWWWWWWWWWWWWWWWWWWWWWWWWAAAAAAAAAAAAAWWWWWWWWWWWWWWWWWWWWWWWWWWWWWWWWWWWWWWWWWWWWWWWWWWWWWWWWWWWWWAAAAAAAAAAAAAAAAAAAAAAAAAAAAAWWWWWWWWWWWWWWWWWWWWWWWWW",
        "~~~~~~~~~~~~~~~~~~~~~~~~~~~~~~~~~~~~~......WWWWWWWWWWWWWWWWWWWWWWWWWWWWWAAAAAAAAAAAAAWWWWWWWWWWWWWWWWWWWWWWWWWWWWWWWWWWWWWWWWWWWWWWWWWWWWWWWWWWWAAAAAAAAAAAAAAAAAAAAAAAAAAAAAAWWWWWWWWWWWWWWWWWWWWWWWWWW",
        "~~~~~~~~~~~~~~~~~~~~~~~~~~~~~~~~~~~~~......WWWWWWWWWWWWWWWWWWWWWWWWWWWWWAAAAAAAAAAAAAWWWWWWWWWWWWWWWWWWWWWWWWWWWWWWWWWWWWWWWWWWWWWWWWWWWWWWWWWAAAAAAAAAAAAAAAAAAAAAAAAAAAAAAAWWWWWWWWWWWWWWWWWWWWWWWWWWW",
        "~~~~~~~~~~~~~~~~~~~~~~~~~~~~~~~~~~~~......WWWWWWWWWWWWWWWWWWWWWWWWWWWWWWAAAAAAAAAAAAAWWWWWWWWWWWWWWWWWWWWWWWWWWWWWWWWWWWWWWWWWWWWWWWWWWWWWWWAAAAAAAAAAAAAAAAAAAAAAAAAAAAAAAAWWWWWWWWWWWWWWWWWWWWWWWWWWWW",
        "~~~~~~~~~~~~~~~~~~~~~~~~~~~~~~~~~~........WWWWWWWWWWWWWWWWWWWWWWWWWWWWWWAAAAAAAAAAAAAWWWWWWWWWWWWWWWWWWWWWWWWWWWWWWWWWWWWWWWWWWWWWWWWWWWWWAAAAAAAAAAAAAAAAAAAAAAAAAAAAAAAAAWWWWWWWWWWWWWWWWWWWWWWWWWWWWW",
        "~~~~~~~~~~~~~~~~~~~~~~~~~~~~~~~~..........WWWWWWWWWWWWWWWWWWWWWWWWWWWWWWAAAAAAAAAAAAAWWWWWWWWWWWWWWWWWWWWWWWWWWWWWWWWWWWWWWWWWWWWWWWWWWWAAAAAAAAAAAAAAAAAAAAAAAAAAAAAAAAAWWWWWWWWWWWWWWWWWWWWWWWWWWWWWWW",
        "~~~~~~~~~~~~~~~~~~~~~~~~~~~~~~~...........WWWWWWWWWWWWWWWWWWWWWWWWWWWWWWAAAAAAAAAAAAAWWWWWWWWWWWWWWWWWWWWWWWWWWWWWWWWWWWWWWWWWWWWWWWWWAAAAAAAAAAAAAAAAAAAAAAAAAAAAAAAAAWWWWWWWWWWWWWWWWWWWWWWWWWWWWWWWWW",
        "~~~~~~~~~~~~~~~~~~~~~~~~~~~~~............WWWWWWWWWWWWWWWWWWWWWWWWWWWWWWWAAAAAAAAAAAAA,WWWWWWWWWWWWWWWWWWWWWWWWWWWWWWWWWWWWWWWWWWWWWWAAAAAAAAAAAAAAAAAAAAAAAAAAAAAAAAAWWWWWWWWWWWWWWWWWWWWWWWWWWWWWWWWWWW",
        "~~~~~~~~~~~~~~~~~~~~~~~~~~~~.............WWWWWWWWWWWWWWWWWWWWWWWWWWWWWWWAAAAAAAAAAAAA,WWWWWWWWWWWWWWWWWWWWWWWWWWWWWWWWWWWWWWWWWWWWAAAAAAAAAAAAAAAAAAAAAAAAAAAAAAAAAWWWWWWWWWWWWWWWWWWWWWWWWWWWWWWWWWWWWW",
        "~~~~~~~~~~~~~~~~~~~~~~~~~~~..............WWWWWWWWWWWWWWWWWWWWWWWWWWWWWWWAAAAAAAAAAAAA,,WWWWWWWWWWWWWWWWWWWWWWWWWWWWWWWWWWWWWWWWWAAAAAAAAAAAAAAAAAAAAAAAAAAAAAAAAAWWWWWWWWWWWWWWWWWWWWWWWWWWWWWWWWWWWWWWW",
        "~~~~~~~~~~~~~~~~~~~~~~~~~~...............WWWWWWWWWWWWWWWWWWWWWWWWWWWWWWWAAAAAAAAAAAAA,,WWWWWWWWWWWWWWWWWWWWWWWWWWWWWWWWWWW,,,,AAAAAAAAAAAAAAAAAAAAAAAAAAAAAAAAAWWWWWWWWWWWWWWWWWWWWWWWWWWWWWWWWWWWWWWWWW",
        "~~~~~~~~~~~~~~~~~~~~~~~~~~...............WWWWWWWWWWWWWWWWWWWWWWWWWWWWWWWAAAAAAAAAAAAA,,WWWWWWWWWWWWWWWWWWWWWWWWWWWWWWWW,,,,,AAAAAAAAAAAAAAAAAAAAAAAAAAAAAAAAAWWWWWWWWWWWWWWWWWWWWWWWWWWWWWWWWWWWWWWWWWWW",
        "~~~~~~~~~~~~~~~~~~~~~~~~~................WWWWWWWWWWWWWWWWWWWWWWWWWWWWWWWAAAAAAAAAAAAA,,,,WWWWWWWWWWWWWWWWWWWWWWWWW,,,,,,,,AAAAAAAAAAAAAAAAAAAAAAAAAAAAAAAAAWWWWWWWWWWWWWWWWWWWWWWWWWWWWWWWWWWWWWWWWWWWWW",
        "~~~~~~~~~~~~~~~~~~~~~~~~~................WWWWWWWWWWWWWWWWWWWWWWWWWWWWWWWAAAAAAAAAAAAA,,,,,,,WWWWWWWWWWWWWWWW,,,,,,,,,,,,AAAAAAAAAAAAAAAAAAAAAAAAAAAAAAAAAWWWWWWWWWWWWWWWWWWWWWWWWWWWWWWWWWWWWWWWWWWWWWWW",
        "~~~~~~~~~~~~~~~~~~~~~~~~~...............WWWWWWWWWWWWWWWWWWWWWWWWWWWWWWWWAAAAAAAAAAAAA,,,,,,,,,,,,,,,,,,,,,,,,,,,,,,,,,AAAAAAAAAAAAAAAAAAAAAAAAAAAAAAAAAWWWWWWWWWWWWWWWWWWWWWWWWWWWWWWWWWWWWWWWWWWWWWWWWW",
        "~~~~~~~~~~~~~~~~~~~~~~~~~..............WWWWWWWWWWWWWWWWWWWWWWWWWWWWWWWWWAAAAAAAAAAAAA,,,,,,,,,,,,,,,,,,,,,,,,,,,,,,,AAAAAAAAAAAAAAAAAAAAAAAAAAAAAAAAAWWWWWWWWWWWWWWWWWWWWWWWWWWWWWWWWWWWWWWWWWWWWWWWWWWW",
        "~~~~~~~~~~~~~~~~~~~~~~~~...............WWWWWWWWWWWWWWWWWWWWWWWWWWWWWWWWWAAAAAAAAAAAAA,,,,,,,,,,,,,,,,,,,,,,,,,,,,,AAAAAAAAAAAAAAAAAAAAAAAAAAAAAAAAAWWWWWWWWWWWWWWWWWWWWWWWWWWWWWWWWWWWWWWWWWWWWWWWWWWWWW",
        "~~~~~~~~~~~~~~~~~~~~~~~~................,,,WWWWWWWWWWWWWWWWWWWWWWWWWWWWWAAAAAAAAAAAAAA,,,,,,,,,,,,,,,,,,,,,,,,,,AAAAAAAAAAAAAAAAAAAAAAAAAAAAAAAAAWWWWWWWWWWWWWWWWWWWWWWWWWWWWWWWWWWWWWWWWWWWWWWWWWWWWWWW",
        "~~~~~~~~~~~~~~~~~~~~~~~~..................,,,,,WWWWWWWWWWWWWWWWWWWWWWWW/AAAAAAAAAAAAAAA,,,,,,,,,,,,,,,,,,,,,,AAAAAAAAAAAAAAAAAAAAAAAAAAAAAAAAAAWWWWWWWWWWWWWWWWWWWWWWWWWWWWWWWWWWWWWWWWWWWWWWWWWWWWWWWWW",
        "~~~~~~~~~~~~~~~~~~~~~~~~..................,,,,,,,,,,,,,,,,,,,,,,,,,,AAA|AAAAAAAAAAAAAAAAAA,,,,,,,,,,,,,,,AAAAAAAAAAAAAAAAAAAAAAAAAAAAAAAAAAAAWWWWWWWWWWWWWWWWWWWWWWWWWWWWWWWWWWWWWWWWWWWWWWWWWWWWWWWWWWW",
        "~~~~~~~~~~~~~~~~~~~~~~~~..............,,,,,,,,,,,,,,,,,,,,,AAAAA,AAAAAA|AAAAAAAAAAAAAAAAAAAAAAAAAAAAAAAAAAAAAAAAAAAAAAAAAAAAAAAAAAAAAAAAAAAWWWWWWWWWWWWWWWWWWWWWWWWWWWWWWWWWWWWWWWWWWWWWWWWWWWWWWWWWWWWW",
        "~~~~~~~~~~~~~~~~~~~~~~~~................,,,,,,,,,,,,,AA,,,A,,,AAAA,,AAA|AAAAAAAAAAAAAAAAAAAAAAAAAAAAAAAAAAAAAAAAAAAAAAAAAAAAAAAAAAAAAAAAAWWWWWWWWWWWWWWWWWWWWWWWWWWWWWWWWWWWWWWWWWWWWWWWWWWWWWWWWWWWWWWW",
        "~~~~~~~~~~~~~~~~~~~~~~~...................,,,,,,,,,,,,,AA,,,AAAAAAAAAAA|AAAAAAAAAAAAAAAAAAAAAAAAAAAAAAAAAAAAAAAAAAAAAAAAAAAAAAAAAAAAAAAWWWWWWWWWWWWWWWWWWWWWWWWWWWWWWWWWWWWWWWWWWWWWWWWWWWWWWWWWWWWWWWWW",
        "~~~~~~~~~~~~~~~~~~~~~~~.................,,,,,,,,,,,,,,,,A,,,,,,AA,AAAAA|AAAAAAAAAAAAAAAAAAAAAAAAAAAAAAAAAAAAAAAAAAAAAAAAAAAAAAAAAAAAWWWWWWWWWWWWWWWWWWWWWWWWWWWWWWWWWWWWWWWWWWWWWWWWWWWWWWWWWWWWWWWWWWWW",
        "~~~~~~~~~~~~~~~~~~~~~~~.................,,,,,,,,,,,,,,,AA,,,,,,AAAAAAAA|AAAAAAAAAAAAAAAAAAAAAAAAAAAAAAAAAAAAAAAAAAAAAAAAAAAAAAAAAAWWWWWWWWWWWWWWWWWWWWWWWWWWWWWWWWWWWWWWWWWWWWWWWWWWWWWWWWWWWWWWWWWWWWWW",
        "~~~~~~~~~~~~~~~~~~~~~~~....................,,,,,,,,,,,,,,,,,,AAA,AAAAAA|AAAAAAAAAAAAAAAAAAAAAAAAAAAAAAAAAAAAAAAAAAAAAAAAAAAAAAAAWWWWWWWWWWWWWWWWWWWWWWWWWWWWWWWWWWWWWWWWWWWWWWWWWWWWWWWWWWWWWWWWWWWWWWWW",
        "~~~~~~~~~~~~~~~~~~~~~~~.................,,,,,,,,,,,A,,A,,AAAAAAA,,AAAAA|AAAAAAAAAAAAAAAAAAAAAAAAAAAAAAAAAAAAAAAAAAAAAAAAAAAAAAWWWWWWWWWWWWWWWWWWWWWWWWWWWWWWWWWWWWWWWWWWWWWWWWWWWWWWWWWWWWWWWWWWWWWWWWWW",
        "~~~~~~~~~~~~~~~~~~~~~~~....................,,,,,,,,,,,AAAA,,,,AAAAAAAAA|AAAAAAAAAAAAAAAAAAAAAAAAAAAAAAAAAAAAAAAAAAAAAAAAAAAAWWWWWWWWWWWWWWWWWWWWWWWWWWWWWWWWWWWWWWWWWWWWWWWWWWWWWWWWWWWWWWWWWWWWWWWWWWWW",
        "~~~~~~~~~~~~~~~~~~~~~~~.................,,,,,,,,,,,,,,,,,A,,AAAAAA,,AAA|AAAAAAAAAAAAAAAAAAAAAAAAAAAAAAAAAAAAAAAAAAAAAAAAAAWWWWWWWWWWWWWWWWWWWWWWWWWWWWWWWWWWWWWWWWWWWWWWWWWWWWWWWWWWWWWWWWWWWWWWWWWWWWWW",
        "~~~~~~~~~~~~~~~~~~~~~~~.................,,,,,,,,,,,,,,,,,,,,,,,,AAAAAAA|AAAAAAAAAAAAAAAAAAAAAAAAAAAAAAAAAAAAAAAAAAAAAAAAWWWWWWWWWWWWWWWWWWWWWWWWWWWWWWWWWWWWWWWWWWWWWWWWWWWWWWWWWWWWWWWWWWWWWWWWWWWWWWWW",
        "~~~~~~~~~~~~~~~~~~~~~~~....................,,,,,,,,,,,,,,,,,AAA,AAAA,AA|AAAAAAAAAAAAAAAAAAAAAAAAAAAAAAAAAAAAAAAAAAAAAAWWWWWWWWWWWWWWWWWWWWWWWWWWWWWWWWWWWWWWWWWWWWWWWWWWWWWWWWWWWWWWWWWWWWWWWWWWWWWWWWWW",
        "~~~~~~~~~~~~~~~~~~~~~~~....................,,,,,,,,,,,,,,,,,,,,,A,,AAAA|AAAAAAAAAAAAAAAAAAAAAAAAAAAAAAAAAAAAAAAAAAAAWWWWWWWWWWWWWWWWWWWWWWWWWWWWWWWWWWWWWWWWWWWWWWWWWWWWWWWWWWWWWWWWWWWWWWWWWWWWWWWWWWWW",
        "~~~~~~~~~~~~~~~~~~~~~~~......................,,WWWWWWWWWWWWWWWWWWWWWWWWWWWWWWWWWWWA------------------------------AWWWWWWWWWWWWWWWWWWWWWWWWWWWWWWWWWWWWWWWWWWWWWWWWWWWWWWWWWWWWWWWWWWWWWWWWWWWWWWWWWWWWWW",
        "~~~~~~~~~~~~~~~~~~~~~~~.....................WWWWWWWWWWWWWWWWWWWWWWWWWWWWWWWWWWWWAAAAAAAAAAAAAAAAAAAAAAAAAAAAAAAAWWWWWWWWWWWWWWWWWWWWWWWWWWWWWWWWWWWWWWWWWWWWWWWWWWWWWWWWWWWWWWWWWWWWWWWWWWWWWWWWWWWWWWWW",
        "~~~~~~~~~~~~~~~~~~~~~~~....................WWWWWWWWWWWWWWWWWWWWWWWWWWWWWWWWWWAAAAAAAAAAAAAAAAAAAAAAAAAAAAAAAAAWWWWWWWWWWWWWWWWWWWWWWWWWWWWWWWWWWWWWWWWWWWWWWWWWWWWWWWWWWWWWWWWWWWWWWWWWWWWWWWWWWWWWWWWWW"
    ],
    "startPoints": [
        [17.5, 3.5],
        [17.5, 4.5],
        [16.5, 3.5],
        [16.5, 4.5],
        [15.5, 3.5]
    ],
    "startPointRotations": [90, 90, 90, 90, 90],
    "raceLines": [
        {
            "mapX": 120.5,
            "mapY": 105.5,
            "length": 10,
            "rotation": 0
        },
        {
            "mapX": 6,
            "mapY": 7.5,
            "length": 4,
            "rotation": 90
        },
        {
            "mapX": 6,
            "mapY": 9.5,
            "length": 4,
            "rotation": 90
        }
    ]
}